Rank,Release Group,Worldwide,Domestic,Foreign,filename,year,Domestic %,Foreign %
1,Avengers: Endgame,2797800564,858373000,1939427564,2019.csv,2019,30.7%,69.3%
2,Star Wars: Episode VII - The Force Awakens,2068223624,936662225,1131561399,2015.csv,2015,45.3%,54.7%
3,Avengers: Infinity War,2048359754,678815482,1369544272,2018.csv,2018,33.1%,66.9%
4,Jurassic World,1670400637,652270625,1018130012,2015.csv,2015,39%,61%
5,The Lion King,1656943394,543638043,1113305351,2019.csv,2019,32.8%,67.2%
6,The Avengers,1518812988,623357910,895455078,2012.csv,2012,41%,59%
7,Furious 7,1515047671,353007020,1162040651,2015.csv,2015,23.3%,76.7%
8,Frozen II,1450026933,477373578,972653355,2019.csv,2019,32.9%,67.1%
9,Avengers: Age of Ultron,1402805868,459005868,943800000,2015.csv,2015,32.7%,67.3%
10,Black Panther,1346913161,700059566,646853595,2018.csv,2018,52%,48%
11,Harry Potter and the Deathly Hallows: Part 2,1341511219,381011219,960500000,2011.csv,2011,28.4%,71.6%
12,Star Wars: Episode VIII - The Last Jedi,1332539889,620181382,712358507,2017.csv,2017,46.5%,53.5%
13,Jurassic World: Fallen Kingdom,1308467944,417719760,890748184,2018.csv,2018,31.9%,68.1%
14,Frozen,1280802282,400738009,880064273,2013.csv,2013,31.3%,68.7%
15,Beauty and the Beast,1263521126,504014165,759506961,2017.csv,2017,39.9%,60.1%
16,Incredibles 2,1242805359,608581744,634223615,2018.csv,2018,49%,51%
17,The Fate of the Furious,1236005118,226008385,1009996733,2017.csv,2017,18.3%,81.7%
18,Iron Man 3,1214811252,409013994,805797258,2013.csv,2013,33.7%,66.3%
19,Minions,1159398397,336045770,823352627,2015.csv,2015,29%,71%
20,Captain America: Civil War,1153296293,408084349,745211944,2016.csv,2016,35.4%,64.6%
21,Aquaman,1148461807,335061807,813400000,2018.csv,2018,29.2%,70.8%
22,The Lord of the Rings: The Return of the King,1140682011,377027325,763654686,2003.csv,2003,33.1%,66.9%
23,Spider-Man: Far from Home,1131927996,390532085,741395911,2019.csv,2019,34.5%,65.5%
24,Captain Marvel,1128274794,426829839,701444955,2019.csv,2019,37.8%,62.2%
25,Transformers: Dark of the Moon,1123794079,352390543,771403536,2011.csv,2011,31.4%,68.6%
26,Skyfall,1108561013,304360277,804200736,2012.csv,2012,27.5%,72.5%
27,Transformers: Age of Extinction,1104054072,245439076,858614996,2014.csv,2014,22.2%,77.8%
28,The Dark Knight Rises,1081041287,448139099,632902188,2012.csv,2012,41.5%,58.5%
29,Joker,1074251311,335451311,738800000,2019.csv,2019,31.2%,68.8%
30,Star Wars: Episode IX - The Rise of Skywalker,1074144248,515202542,558941706,2019.csv,2019,48%,52%
31,Toy Story 4,1073394593,434038008,639356585,2019.csv,2019,40.4%,59.6%
32,Toy Story 3,1066969703,415004880,651964823,2010.csv,2010,38.9%,61.1%
33,Rogue One: A Star Wars Story,1056057273,532177324,523879949,2016.csv,2016,50.4%,49.6%
34,Aladdin,1050693953,355559216,695134737,2019.csv,2019,33.8%,66.2%
35,Pirates of the Caribbean: On Stranger Tides,1045713802,241071802,804642000,2011.csv,2011,23.1%,76.9%
36,Despicable Me 3,1034799409,264624300,770175109,2017.csv,2017,25.6%,74.4%
37,Finding Dory,1028570889,486295561,542275328,2016.csv,2016,47.3%,52.7%
38,Alice in Wonderland,1025467110,334191110,691276000,2010.csv,2010,32.6%,67.4%
39,Zootopia,1023784195,341268248,682515947,2016.csv,2016,33.3%,66.7%
40,The Hobbit: An Unexpected Journey,1017003568,303003568,714000000,2012.csv,2012,29.8%,70.2%
41,Harry Potter and the Deathly Hallows: Part 1,976536918,295983305,680553613,2010.csv,2010,30.3%,69.7%
42,Harry Potter and the Sorcerer's Stone,974755371,317575550,657179821,2001.csv,2001,32.6%,67.4%
43,Despicable Me 2,970766005,368065385,602700620,2013.csv,2013,37.9%,62.1%
44,The Jungle Book,966550600,364001123,602549477,2016.csv,2016,37.7%,62.3%
45,Jumanji: Welcome to the Jungle,962077546,404515480,557562066,2017.csv,2017,42%,58%
46,The Hobbit: The Desolation of Smaug,958366855,258366855,700000000,2013.csv,2013,27%,73%
47,The Hobbit: The Battle of the Five Armies,956019788,255119788,700900000,2014.csv,2014,26.7%,73.3%
48,The Lord of the Rings: The Two Towers,936689735,339789881,596899854,2002.csv,2002,36.3%,63.7%
49,Shrek 2,928760770,441226247,487534523,2004.csv,2004,47.5%,52.5%
50,Bohemian Rhapsody,903655259,216428042,687227217,2018.csv,2018,24%,76%
51,Harry Potter and the Goblet of Fire,895921036,290013036,605908000,2005.csv,2005,32.4%,67.6%
52,The Lord of the Rings: The Fellowship of the Ring,883726270,313364114,570362156,2001.csv,2001,35.5%,64.5%
53,Spectre,880674609,200074609,680600000,2015.csv,2015,22.7%,77.3%
54,Spider-Man: Homecoming,880166924,334201140,545965784,2017.csv,2017,38%,62%
55,Harry Potter and the Chamber of Secrets,878979634,261988482,616991152,2002.csv,2002,29.8%,70.2%
56,Ice Age: Continental Drift,877244782,161321843,715922939,2012.csv,2012,18.4%,81.6%
57,The Secret Life of Pets,875457937,368384330,507073607,2016.csv,2016,42.1%,57.9%
58,Batman v Superman: Dawn of Justice,873634919,330360194,543274725,2016.csv,2016,37.8%,62.2%
59,Finding Nemo,871014978,339714978,531300000,2003.csv,2003,39%,61%
60,Wolf Warrior 2,870325439,2721100,867604339,2017.csv,2017,0.3%,99.7%
61,Star Wars: Episode III - Revenge of the Sith,868352530,380270577,488081953,2005.csv,2005,43.8%,56.2%
62,The Hunger Games: Catching Fire,865011746,424668047,440343699,2013.csv,2013,49.1%,50.9%
63,Guardians of the Galaxy Vol. 2,863756051,389813101,473942950,2017.csv,2017,45.1%,54.9%
64,Inside Out,857611174,356461711,501149463,2015.csv,2015,41.6%,58.4%
65,Venom,856085151,213515506,642569645,2018.csv,2018,24.9%,75.1%
66,Thor: Ragnarok,853977126,315058289,538918837,2017.csv,2017,36.9%,63.1%
67,The Twilight Saga: Breaking Dawn - Part 2,829746820,292324737,537422083,2012.csv,2012,35.2%,64.8%
68,Inception,828322032,292576195,535745837,2010.csv,2010,35.3%,64.7%
69,Wonder Woman,821847012,412563408,409283604,2017.csv,2017,50.2%,49.8%
70,Spider-Man,821708551,403706375,418002176,2002.csv,2002,49.1%,50.9%
71,Fantastic Beasts and Where to Find Them,814037575,234037575,580000000,2016.csv,2016,28.8%,71.2%
72,Coco,807082196,209726015,597356181,2017.csv,2017,26%,74%
73,Jumanji: The Next Level,796575993,316831246,479744747,2019.csv,2019,39.8%,60.2%
74,Harry Potter and the Prisoner of Azkaban,795634069,249541069,546093000,2004.csv,2004,31.4%,68.6%
75,Pirates of the Caribbean: Dead Men Tell No Tales,794861794,172558876,622302918,2017.csv,2017,21.7%,78.3%
76,Mission: Impossible - Fallout,791115104,220159104,570956000,2018.csv,2018,27.8%,72.2%
77,Spider-Man 2,788976453,373585825,415390628,2004.csv,2004,47.4%,52.6%
78,Fast & Furious 6,788679850,238679850,550000000,2013.csv,2013,30.3%,69.7%
79,Deadpool,782612155,363070709,419541446,2016.csv,2016,46.4%,53.6%
80,Guardians of the Galaxy,772776600,333176600,439600000,2014.csv,2014,43.1%,56.9%
81,Fast & Furious Presents: Hobbs & Shaw,759056935,173956935,585100000,2019.csv,2019,22.9%,77.1%
82,Maleficent,758410378,241410378,517000000,2014.csv,2014,31.8%,68.2%
83,The Amazing Spider-Man,757930663,262030663,495900000,2012.csv,2012,34.6%,65.4%
84,The Hunger Games: Mockingjay - Part 1,755356711,337135885,418220826,2014.csv,2014,44.6%,55.4%
85,Shrek Forever After,752600867,238736787,513864080,2010.csv,2010,31.7%,68.3%
86,Madagascar 3: Europe's Most Wanted,746921274,216391482,530529792,2012.csv,2012,29%,71%
87,Suicide Squad,746846894,325100054,421746840,2016.csv,2016,43.5%,56.5%
88,X-Men: Days of Future Past,746045700,233921534,512124166,2014.csv,2014,31.4%,68.6%
89,"The Chronicles of Narnia: The Lion, the Witch and the Wardrobe",745013115,291710957,453302158,2005.csv,2005,39.2%,60.8%
90,Monsters University,743559607,268492764,475066843,2013.csv,2013,36.1%,63.9%
91,The Matrix Reloaded,739412035,281576461,457835574,2003.csv,2003,38.1%,61.9%
92,Deadpool 2,734546611,318491426,416055185,2018.csv,2018,43.4%,56.6%
93,Ne Zha,726063471,3695533,722367938,2019.csv,2019,0.5%,99.5%
94,Gravity,723192705,274092705,449100000,2013.csv,2013,37.9%,62.1%
95,Captain America: The Winter Soldier,714421503,259766572,454654931,2014.csv,2014,36.4%,63.6%
96,The Twilight Saga: Breaking Dawn - Part 1,712205856,281287133,430918723,2011.csv,2011,39.5%,60.5%
97,Dawn of the Planet of the Apes,710644566,208545589,502098977,2014.csv,2014,29.3%,70.7%
98,The Amazing Spider-Man 2,708982323,202853933,506128390,2014.csv,2014,28.6%,71.4%
99,It,700381748,327481748,372900000,2017.csv,2017,46.8%,53.2%
100,The Wandering Earth,699760773,5875487,693885286,2019.csv,2019,0.8%,99.2%
101,The Twilight Saga: Eclipse,698491347,300531751,397959596,2010.csv,2010,43%,57%
102,Mission: Impossible - Ghost Protocol,694713380,209397903,485315477,2011.csv,2011,30.1%,69.9%
103,The Hunger Games,694394724,408010692,286384032,2012.csv,2012,58.8%,41.2%
104,Mission: Impossible - Rogue Nation,682714267,195042377,487671890,2015.csv,2015,28.6%,71.4%
105,Doctor Strange,677718395,232641920,445076475,2016.csv,2016,34.3%,65.7%
106,Interstellar,677463813,188020017,489443796,2014.csv,2014,27.8%,72.2%
107,Man of Steel,668045518,291045518,377000000,2013.csv,2013,43.6%,56.4%
108,Kung Fu Panda 2,665692281,165249063,500443218,2011.csv,2011,24.8%,75.2%
109,The Hunger Games: Mockingjay - Part 2,658344137,281723902,376620235,2015.csv,2015,42.8%,57.2%
110,Justice League,657924295,229024295,428900000,2017.csv,2017,34.8%,65.2%
111,Big Hero 6,657827828,222527828,435300000,2014.csv,2014,33.8%,66.2%
112,Fantastic Beasts: The Crimes of Grindelwald,654855901,159555901,495300000,2018.csv,2018,24.4%,75.6%
113,Pirates of the Caribbean: The Curse of the Black Pearl,654264015,305413918,348850097,2003.csv,2003,46.7%,53.3%
114,Star Wars: Episode II - Attack of the Clones,645256452,302191252,343065200,2002.csv,2002,46.8%,53.2%
115,Thor: The Dark World,644783140,206362140,438421000,2013.csv,2013,32%,68%
116,Moana,643331111,248757044,394574067,2016.csv,2016,38.7%,61.3%
117,Sing,634151679,270395425,363756254,2016.csv,2016,42.6%,57.4%
118,The Incredibles,631442092,261441092,370001000,2004.csv,2004,41.4%,58.6%
119,The Martian,630161890,228433663,401728227,2015.csv,2015,36.2%,63.8%
120,Fast Five,626137675,209837675,416300000,2011.csv,2011,33.5%,66.5%
121,Men in Black 3,624026776,179020854,445005922,2012.csv,2012,28.7%,71.3%
122,Iron Man 2,623933331,312433331,311500000,2010.csv,2010,50.1%,49.9%
123,Ant-Man and the Wasp,622674139,216648740,406025399,2018.csv,2018,34.8%,65.2%
124,How to Train Your Dragon 2,621537519,177002924,444534595,2014.csv,2014,28.5%,71.5%
125,Logan,619021436,226277068,392744368,2017.csv,2017,36.6%,63.4%
126,The Passion of the Christ,611486736,370274604,241212132,2004.csv,2004,60.6%,39.4%
127,Life of Pi,609016565,124987023,484029542,2012.csv,2012,20.5%,79.5%
128,Transformers: The Last Knight,605425157,130168683,475256474,2017.csv,2017,21.5%,78.5%
129,War of the Worlds,603873119,234280354,369592765,2005.csv,2005,38.8%,61.2%
130,Tangled,592461732,200821936,391639796,2010.csv,2010,33.9%,66.1%
131,The Croods,587204668,187168425,400036243,2013.csv,2013,31.9%,68.1%
132,The Hangover Part II,586764305,254464305,332300000,2011.csv,2011,43.4%,56.6%
133,Ready Player One,582890172,137690172,445200000,2018.csv,2018,23.6%,76.4%
134,Operation Red Sea,579330426,1543547,577786879,2018.csv,2018,0.3%,99.7%
135,Fifty Shades of Grey,569651467,166167230,403484237,2015.csv,2015,29.2%,70.8%
136,Kong: Skull Island,566652812,168052812,398600000,2017.csv,2017,29.7%,70.3%
137,The Smurfs,563749323,142614158,421135165,2011.csv,2011,25.3%,74.7%
138,King Kong,562363449,218080025,344283424,2005.csv,2005,38.8%,61.2%
139,Cars 2,559852396,191452396,368400000,2011.csv,2011,34.2%,65.8%
140,Puss in Boots,554987477,149260504,405726973,2011.csv,2011,26.9%,73.1%
141,The Mermaid,553810228,3232685,550577543,2016.csv,2016,0.6%,99.4%
142,The Day After Tomorrow,552639571,186740799,365898772,2004.csv,2004,33.8%,66.2%
143,Ted,549368315,218815487,330552828,2012.csv,2012,39.8%,60.2%
144,American Sniper,547426372,350126372,197300000,2014.csv,2014,64%,36%
145,Mission: Impossible II,546388108,215409889,330978219,2000.csv,2000,39.4%,60.6%
146,Detective Chinatown 2,544185156,1983984,542201172,2018.csv,2018,0.4%,99.6%
147,X-Men: Apocalypse,543934105,155442489,388491616,2016.csv,2016,28.6%,71.4%
148,Sherlock Holmes: A Game of Shadows,543848418,186848418,357000000,2011.csv,2011,34.4%,65.6%
149,Despicable Me,543113985,251513985,291600000,2010.csv,2010,46.3%,53.7%
150,Cinderella,542351353,201151353,341200000,2015.csv,2015,37.1%,62.9%
151,Madagascar,542063846,193595521,348468325,2005.csv,2005,35.7%,64.3%
152,World War Z,540007876,202359711,337648165,2013.csv,2013,37.5%,62.5%
153,Brave,538983207,237283207,301700000,2012.csv,2012,44%,56%
154,The Revenant,532950503,183637894,349312609,2015.csv,2015,34.5%,65.5%
155,The Meg,530243742,145443742,384800000,2018.csv,2018,27.4%,72.6%
156,Ralph Breaks the Internet,529323962,201091711,328232251,2018.csv,2018,38%,62%
157,"Monsters, Inc.",528773250,255873250,272900000,2001.csv,2001,48.4%,51.6%
158,Hotel Transylvania 3: Summer Vacation,528583774,167510016,361073758,2018.csv,2018,31.7%,68.3%
159,The Boss Baby,527965936,175003033,352962903,2017.csv,2017,33.1%,66.9%
160,Dunkirk,525245546,188045546,337200000,2017.csv,2017,35.8%,64.2%
161,Godzilla,524976069,200676069,324300000,2014.csv,2014,38.2%,61.8%
162,Meet the Fockers,522657936,279261160,243396776,2004.csv,2004,53.4%,46.6%
163,How to Train Your Dragon: The Hidden World,521799505,160799505,361000000,2019.csv,2019,30.8%,69.2%
164,Kung Fu Panda 3,521170825,143528619,377642206,2016.csv,2016,27.5%,72.5%
165,Ant-Man,519311965,180202163,339109802,2015.csv,2015,34.7%,65.3%
166,Dr. Seuss' The Grinch,511595957,270620950,240975007,2018.csv,2018,52.9%,47.1%
167,Rio 2,498781117,131538435,367242682,2014.csv,2014,26.4%,73.6%
168,Troy,497409852,133378256,364031596,2004.csv,2004,26.8%,73.2%
169,How to Train Your Dragon,494878759,217581231,277297528,2010.csv,2010,44%,56%
170,Oz the Great and Powerful,493311825,234911825,258400000,2013.csv,2013,47.6%,52.4%
171,Clash of the Titans,493214993,163214888,330000105,2010.csv,2010,33.1%,66.9%
172,Maleficent: Mistress of Evil,491730089,113929605,377800484,2019.csv,2019,23.2%,76.8%
173,War for the Planet of the Apes,490719763,146880162,343839601,2017.csv,2017,29.9%,70.1%
174,Mr. & Mrs. Smith,487287646,186336279,300951367,2005.csv,2005,38.2%,61.8%
175,Teenage Mutant Ninja Turtles,485004754,191204754,293800000,2014.csv,2014,39.4%,60.6%
176,Bruce Almighty,484592874,242829261,241763613,2003.csv,2003,50.1%,49.9%
177,Shrek,484409218,267665011,216744207,2001.csv,2001,55.3%,44.7%
178,Rio,483866518,143619809,340246709,2011.csv,2011,29.7%,70.3%
179,Rise of the Planet of the Apes,481800873,176760185,305040688,2011.csv,2011,36.7%,63.3%
180,Charlie and the Chocolate Factory,474968763,206459076,268509687,2005.csv,2005,43.5%,56.5%
181,Hotel Transylvania 2,474800000,169700110,305099890,2015.csv,2015,35.7%,64.3%
182,San Andreas,473990832,155190832,318800000,2015.csv,2015,32.7%,67.3%
183,It Chapter Two,473093228,211593228,261500000,2019.csv,2019,44.7%,55.3%
184,Wreck-It Ralph,471222889,189422889,281800000,2012.csv,2012,40.2%,59.8%
185,The Lego Movie,468060692,257760692,210300000,2014.csv,2014,55.1%,44.9%
186,Bumblebee,467989645,127195589,340794056,2018.csv,2018,27.2%,72.8%
187,Star Trek Into Darkness,467365246,228778661,238586585,2013.csv,2013,49%,51%
188,Gladiator,460583960,187705427,272878533,2000.csv,2000,40.8%,59.2%
189,Lucy,458863600,126663600,332200000,2014.csv,2014,27.6%,72.4%
190,The Last Samurai,454627263,111127263,343500000,2003.csv,2003,24.4%,75.6%
191,Ocean's Eleven,450717150,183417150,267300000,2001.csv,2001,40.7%,59.3%
192,"My People, My Country",450064993,2356683,447708310,2019.csv,2019,0.5%,99.5%
193,Thor,449326618,181030624,268295994,2011.csv,2011,40.3%,59.7%
194,Pearl Harbor,449220945,198542554,250678391,2001.csv,2001,44.2%,55.8%
195,La La Land,446171671,151101803,295069868,2016.csv,2016,33.9%,66.1%
196,Men in Black II,441818803,190418803,251400000,2002.csv,2002,43.1%,56.9%
197,Les Misérables,441809770,148809770,293000000,2012.csv,2012,33.7%,66.3%
198,Terminator Genisys,440603537,89760956,350842581,2015.csv,2015,20.4%,79.6%
199,Warcraft,439048914,47365290,391683624,2016.csv,2016,10.8%,89.2%
200,A Star Is Born,436188866,215288866,220900000,2018.csv,2018,49.4%,50.6%
201,The Greatest Showman,434993183,174340174,260653009,2017.csv,2017,40.1%,59.9%
202,Terminator 3: Rise of the Machines,433371112,150371112,283000000,2003.csv,2003,34.7%,65.3%
203,The Mummy Returns,433013274,202019785,230993489,2001.csv,2001,46.7%,53.3%
204,Pokémon Detective Pikachu,433005346,144105346,288900000,2019.csv,2019,33.3%,66.7%
205,Die Another Day,431971116,160942139,271028977,2002.csv,2002,37.3%,62.7%
206,The Secret Life of Pets 2,430051293,158874395,271176898,2019.csv,2019,36.9%,63.1%
207,Cast Away,429632142,233632142,196000000,2000.csv,2000,54.4%,45.6%
208,Rampage,428028233,101028233,327000000,2018.csv,2018,23.6%,76.4%
209,The Matrix Revolutions,427343298,139313948,288029350,2003.csv,2003,32.6%,67.4%
210,The Intouchables,426588510,10198820,416389690,2011.csv,2011,2.4%,97.6%
211,Bad Boys for Life,425514702,204417855,221096847,2020.csv,2020,48%,52%
212,Django Unchained,425368238,162805434,262562804,2012.csv,2012,38.3%,61.7%
213,The King's Speech,423999102,135453143,288545959,2010.csv,2010,31.9%,68.1%
214,The Captain,416953262,706572,416246690,2019.csv,2019,0.2%,99.8%
215,The Chronicles of Narnia: The Voyage of the Dawn Treader,415686217,104386950,311299267,2010.csv,2010,25.1%,74.9%
216,Jason Bourne,415484914,162434410,253050504,2016.csv,2016,39.1%,60.9%
217,The Wolverine,414828246,132556852,282271394,2013.csv,2013,32%,68%
218,Kingsman: The Secret Service,414351546,128261724,286089822,2015.csv,2015,31%,69%
219,Pacific Rim,411002906,101802906,309200000,2013.csv,2013,24.8%,75.2%
220,Kingsman: The Golden Circle,410902662,100234838,310667824,2017.csv,2017,24.4%,75.6%
221,The Mummy,409231607,80227895,329003712,2017.csv,2017,19.6%,80.4%
222,Ice Age: Collision Course,408579038,64063008,344516030,2016.csv,2016,15.7%,84.3%
223,Signs,408247917,227966634,180281283,2002.csv,2002,55.8%,44.2%
224,X2: X-Men United,407711549,214949694,192761855,2003.csv,2003,52.7%,47.3%
225,Alita: Battle Angel,404852543,85710210,319142333,2019.csv,2019,21.2%,78.8%
226,Prometheus,403354469,126477084,276877385,2012.csv,2012,31.4%,68.6%
227,TRON: Legacy,400062763,172062763,228000000,2010.csv,2010,43%,57%
228,Mission: Impossible III,398479497,134029801,264449696,2005.csv,2005,33.6%,66.4%
229,Snow White and the Huntsman,396592829,155332381,241260448,2012.csv,2012,39.2%,60.8%
230,Mamma Mia! Here We Go Again,395044706,120634935,274409771,2018.csv,2018,30.5%,69.5%
231,Solo: A Star Wars Story,392924807,213767512,179157295,2018.csv,2018,54.4%,45.6%
232,The Wolf of Wall Street,392000694,116900694,275100000,2013.csv,2013,29.8%,70.2%
233,Independence Day: Resurgence,389681935,103144286,286537649,2016.csv,2016,26.5%,73.5%
234,Monster Hunt,387053506,32766,387020740,2015.csv,2015,<0.1%,100%
235,Godzilla: King of the Monsters,386600138,110500138,276100000,2019.csv,2019,28.6%,71.4%
236,Home,386041607,177397510,208644097,2015.csv,2015,46%,54%
237,Cars 3,383930656,152901115,231029541,2017.csv,2017,39.8%,60.2%
238,Ice Age,383257136,176387405,206869731,2002.csv,2002,46%,54%
239,Fifty Shades Darker,381545846,114581250,266964596,2017.csv,2017,30%,70%
240,Taken 2,376141306,139854287,236287019,2012.csv,2012,37.2%,62.8%
241,G.I. Joe: Retaliation,375740705,122523060,253217645,2013.csv,2013,32.6%,67.4%
242,Spider-Man: Into the Spider-Verse,375540831,190241310,185299521,2018.csv,2018,50.7%,49.3%
243,Mad Max: Fury Road,374736354,153636354,221100000,2015.csv,2015,41%,59%
244,Shark Tale,374583879,160861908,213721971,2004.csv,2004,42.9%,57.1%
245,Once Upon a Time... in Hollywood,374343626,142502728,231840898,2019.csv,2019,38.1%,61.9%
246,What Women Want,374111707,182811707,191300000,2000.csv,2000,48.9%,51.1%
247,The Adventures of Tintin,373993951,77591831,296402120,2011.csv,2011,20.7%,79.3%
248,Penguins of Madagascar,373515621,83850911,289664710,2014.csv,2014,22.4%,77.6%
249,Fifty Shades Freed,371985018,100407760,271577258,2018.csv,2018,27%,73%
250,Batman Begins,371853783,205343774,166510009,2005.csv,2005,55.2%,44.8%
251,Hitch,371594210,179495555,192098655,2005.csv,2005,48.3%,51.7%
252,Captain America: The First Avenger,370569774,176654505,193915269,2011.csv,2011,47.7%,52.3%
253,Edge of Tomorrow,370541256,100206256,270335000,2014.csv,2014,27%,73%
254,Gone Girl,369330363,167767189,201563174,2014.csv,2014,45.4%,54.6%
255,Jurassic Park III,368780809,181171875,187608934,2001.csv,2001,49.1%,50.9%
256,My Big Fat Greek Wedding,368744044,241438208,127305836,2002.csv,2002,65.5%,34.5%
257,1917,368027644,159227644,208800000,2019.csv,2019,43.3%,56.7%
258,Shazam!,365971656,140371656,225600000,2019.csv,2019,38.4%,61.6%
259,The Nun,365550119,117450119,248100000,2018.csv,2018,32.1%,67.9%
260,Night at the Museum: Secret of the Tomb,363204635,113746621,249458014,2014.csv,2014,31.3%,68.7%
261,Ocean's Twelve,362744280,125544280,237200000,2004.csv,2004,34.6%,65.4%
262,Planet of the Apes,362211740,180011740,182200000,2001.csv,2001,49.7%,50.3%
263,The Hangover Part III,362000072,112200072,249800000,2013.csv,2013,31%,69%
264,Monster Hunt 2,361682618,706153,360976465,2018.csv,2018,0.2%,99.8%
265,Noah,359200044,101200044,258000000,2014.csv,2014,28.2%,71.8%
266,The Karate Kid,359126022,176591618,182534404,2010.csv,2010,49.2%,50.8%
267,Your Name.,358922706,5017246,353905460,2016.csv,2016,1.4%,98.6%
268,Hotel Transylvania,358375603,148313048,210062555,2011.csv,2011,41.4%,58.6%
269,Minority Report,358372926,132072926,226300000,2002.csv,2002,36.9%,63.1%
270,The Legend of Tarzan,356700357,126643061,230057296,2016.csv,2016,35.5%,64.5%
271,The Great Gatsby,353641895,144840419,208801476,2013.csv,2013,41%,59%
272,Dumbo,353284621,114766307,238518314,2019.csv,2019,32.5%,67.5%
273,"I, Robot",353133898,144801023,208332875,2004.csv,2004,41%,59%
274,Murder on the Orient Express,352789811,102826543,249963268,2017.csv,2017,29.1%,70.9%
275,X-Men: First Class,352616690,146408305,206208385,2011.csv,2011,41.5%,58.5%
276,The Angry Birds Movie,352333929,107509366,244824563,2016.csv,2016,30.5%,69.5%
277,Catch Me If You Can,352114312,164615351,187498961,2002.csv,2002,46.8%,53.2%
278,Now You See Me,351723989,117723989,234000000,2013.csv,2013,33.5%,66.5%
279,Hannibal,351692268,165092268,186600000,2001.csv,2001,46.9%,53.1%
280,Peter Rabbit,351266433,115253424,236013009,2018.csv,2018,32.8%,67.2%
281,Dinosaur,349822765,137748063,212074702,2000.csv,2000,39.4%,60.6%
282,Mary Poppins Returns,349537494,171958438,177579056,2018.csv,2018,49.2%,50.8%
283,The Lorax,348840316,214030500,134809816,2012.csv,2012,61.4%,38.6%
284,The Maze Runner,348319861,102427862,245891999,2014.csv,2014,29.4%,70.6%
285,The Smurfs 2,347545360,71017784,276527576,2013.csv,2013,20.4%,79.6%
286,National Treasure,347512318,173008894,174503424,2004.csv,2004,49.8%,50.2%
287,Rush Hour 2,347325802,226164286,121161516,2001.csv,2001,65.1%,34.9%
288,Trolls,346864462,153707064,193157398,2016.csv,2016,44.3%,55.7%
289,xXx: Return of Xander Cage,346118277,44898413,301219864,2017.csv,2017,13%,87%
290,How the Grinch Stole Christmas,345141403,260044825,85096578,2000.csv,2000,75.3%,24.7%
291,Titanic 2012 3D Release,343550770,57884114,285666656,2012.csv,2012,16.8%,83.2%
292,Star Trek Beyond,343471816,158848340,184623476,2016.csv,2016,46.2%,53.8%
293,Alvin and the Chipmunks: Chipwrecked,342695435,133110742,209584693,2011.csv,2011,38.8%,61.2%
294,A Quiet Place,340939361,188024361,152915000,2018.csv,2018,55.1%,44.9%
295,300: Rise of an Empire,337580051,106580051,231000000,2014.csv,2014,31.6%,68.4%
296,Journey 2: The Mysterious Island,335260290,103860290,231400000,2012.csv,2012,31%,69%
297,The Great Wall,334933831,45540830,289393001,2016.csv,2016,13.6%,86.4%
298,Now You See Me 2,334897606,65075540,269822066,2016.csv,2016,19.4%,80.6%
299,Fantastic Four,333535934,154696080,178839854,2005.csv,2005,46.4%,53.6%
300,The Good Dinosaur,332207671,123087120,209120551,2015.csv,2015,37.1%,62.9%
301,22 Jump Street,331333876,191719337,139614539,2014.csv,2014,57.9%,42.1%
302,Meet the Parents,330444045,166244045,164200000,2000.csv,2000,50.3%,49.7%
303,Black Swan,329398046,106954678,222443368,2010.csv,2010,32.5%,67.5%
304,The Perfect Storm,328718434,182618434,146100000,2000.csv,2000,55.6%,44.4%
305,Green Book,326750920,85080171,241670749,2018.csv,2018,26%,74%
306,John Wick: Chapter 3 - Parabellum,326709727,171015687,155694040,2019.csv,2019,52.3%,47.7%
307,Taken 3,326479141,89256424,237222717,2015.csv,2015,27.3%,72.7%
308,The SpongeBob Movie: Sponge Out of Water,325186032,162994032,162192000,2015.csv,2015,50.1%,49.9%
309,Megamind,321885765,148415853,173469912,2010.csv,2010,46.1%,53.9%
310,Robin Hood,321669741,105269730,216400011,2010.csv,2010,32.7%,67.3%
311,The Conjuring 2,320392818,102470008,217922810,2016.csv,2016,32%,68%
312,The Last Airbender,319713881,131772187,187941694,2010.csv,2010,41.2%,58.8%
313,The Conjuring,319494638,137400141,182094497,2013.csv,2013,43%,57%
314,The Expendables 2,314975955,85028192,229947763,2012.csv,2012,27%,73%
315,Chicken Little,314432837,135386665,179046172,2005.csv,2005,43.1%,56.9%
316,A Beautiful Mind,313542341,170742341,142800000,2001.csv,2001,54.5%,45.5%
317,Maze Runner: The Scorch Trials,312296056,81697192,230598864,2015.csv,2015,26.2%,73.8%
318,Resident Evil: The Final Chapter,312242626,26830068,285412558,2016.csv,2016,8.6%,91.4%
319,The Lego Batman Movie,311950384,175750384,136200000,2017.csv,2017,56.3%,43.7%
320,Knives Out,311553190,165363234,146189956,2019.csv,2019,53.1%,46.9%
321,Little Fockers,310650585,148438600,162211985,2010.csv,2010,47.8%,52.2%
322,The Ex-File 3: The Return of The Exes,307592427,838959,306753468,2017.csv,2017,0.3%,99.7%
323,The Fault in Our Stars,307166834,124872350,182294484,2014.csv,2014,40.7%,59.3%
324,Rise of the Guardians,306941670,103412758,203528912,2012.csv,2012,33.7%,66.3%
325,Chicago,306776732,170687518,136089214,2002.csv,2002,55.6%,44.4%
326,Sonic the Hedgehog,306766470,146066470,160700000,2020.csv,2020,47.6%,52.4%
327,Annabelle: Creation,306515884,102092201,204423683,2017.csv,2017,33.3%,66.7%
328,Wonder,305937718,132422809,173514909,2017.csv,2017,43.3%,56.7%
329,Skyscraper,304868961,68420120,236448841,2018.csv,2018,22.4%,77.6%
330,A Good Day to Die Hard,304654182,67349198,237304984,2013.csv,2013,22.1%,77.9%
331,Dangal,303723636,12391761,291331875,2016.csv,2016,4.1%,95.9%
332,Passengers,303144152,100014699,203129453,2016.csv,2016,33%,67%
333,Battleship,303025485,65422625,237602860,2012.csv,2012,21.6%,78.4%
334,Wrath of the Titans,301970083,83670083,218300000,2012.csv,2012,27.7%,72.3%
335,Resident Evil: Afterlife,300228084,60128566,240099518,2010.csv,2010,20%,80%
336,Van Helsing,300157638,120177084,179980554,2004.csv,2004,40%,60%
337,Alice Through the Looking Glass,299457024,77041381,222415643,2016.csv,2016,25.7%,74.3%
338,Real Steel,299268508,85468508,213800000,2011.csv,2011,28.6%,71.4%
339,Ocean's Eight,297718711,140218711,157500000,2018.csv,2018,47.1%,52.9%
340,Insurgent,297002527,130179072,166823455,2015.csv,2015,43.8%,56.2%
341,Austin Powers in Goldmember,296938801,213307889,83630912,2002.csv,2002,71.8%,28.2%
342,Miss Peregrine's Home for Peculiar Children,296482446,87242834,209239612,2016.csv,2016,29.4%,70.6%
343,X-Men,296339528,157299718,139039810,2000.csv,2000,53.1%,46.9%
344,Ferdinand,296069199,84410380,211658819,2017.csv,2017,28.5%,71.5%
345,Shutter Island,294804195,128012934,166791261,2010.csv,2010,43.4%,56.6%
346,Salt,293503354,118311368,175191986,2010.csv,2010,40.3%,59.7%
347,What Lies Beneath,291420351,155464351,135956000,2000.csv,2000,53.3%,46.7%
348,Pacific Rim: Uprising,290930148,59874525,231055623,2018.csv,2018,20.6%,79.4%
349,Sex and the City 2,290745055,95347692,195397363,2010.csv,2010,32.8%,67.2%
350,The Bourne Supremacy,290633422,176241941,114391481,2004.csv,2004,60.6%,39.4%
351,Divergent,288885818,150947895,137937923,2014.csv,2014,52.3%,47.7%
352,Wedding Crashers,288467645,209255921,79211724,2005.csv,2005,72.5%,27.5%
353,Bridesmaids,288383523,169106725,119276798,2011.csv,2011,58.6%,41.4%
354,Maze Runner: The Death Cure,288175335,58032443,230142892,2018.csv,2018,20.1%,79.9%
355,American Pie 2,287553595,145103595,142450000,2001.csv,2001,50.5%,49.5%
356,Pitch Perfect 2,287144079,184296230,102847849,2015.csv,2015,64.2%,35.8%
357,Oblivion,286168572,89107235,197061337,2013.csv,2013,31.1%,68.9%
358,Elysium,286140700,93050117,193090583,2013.csv,2013,32.5%,67.5%
359,The Polar Express,286000505,162775358,123225147,2004.csv,2004,56.9%,43.1%
360,John Carter,284139100,73078100,211061000,2012.csv,2012,25.7%,74.3%
361,Paddington,282839394,76271832,206567562,2014.csv,2014,27%,73%
362,Turbo,282570682,83028128,199542554,2013.csv,2013,29.4%,70.6%
363,Bridget Jones's Diary,281929795,71543427,210386368,2001.csv,2001,25.4%,74.6%
364,The Tourist,278780441,67631157,211149284,2010.csv,2010,24.3%,75.7%
365,Split,278454358,138291365,140162993,2017.csv,2017,49.7%,50.3%
366,Scary Movie,278019771,157019771,121000000,2000.csv,2000,56.5%,43.5%
367,xXx,277448382,142109382,135339000,2002.csv,2002,51.2%,48.8%
368,The Bourne Legacy,276144750,113203870,162940880,2012.csv,2012,41%,59%
369,Mr. Peabody & Sherman,275698039,111506430,164191609,2014.csv,2014,40.4%,59.6%
370,Scooby-Doo,275650703,153294164,122356539,2002.csv,2002,55.6%,44.4%
371,Lincoln,275293450,182207973,93085477,2012.csv,2012,66.2%,33.8%
372,Spirited Away,274925095,10055859,264869236,2001.csv,2001,3.7%,96.3%
373,Lara Croft: Tomb Raider,274703340,131168070,143535270,2001.csv,2001,47.7%,52.3%
374,Tomb Raider,274650803,58250803,216400000,2018.csv,2018,21.2%,78.8%
375,The Expendables,274470394,103068524,171401870,2010.csv,2010,37.6%,62.4%
376,Cloudy with a Chance of Meatballs 2,274325949,119793567,154532382,2013.csv,2013,43.7%,56.3%
377,Bad Boys II,273339556,138608444,134731112,2003.csv,2003,50.7%,49.3%
378,Lilo & Stitch,273144151,145794338,127349813,2002.csv,2002,53.4%,46.6%
379,Grown Ups,271430189,162001186,109429003,2010.csv,2010,59.7%,40.3%
380,Neighbors,270665134,150157400,120507734,2014.csv,2014,55.5%,44.5%
381,We're the Millers,269994119,150394119,119600000,2012.csv,2012,55.7%,44.3%
382,Epic,268426634,107518682,160907952,2013.csv,2013,40.1%,59.9%
383,Exodus: Gods and Kings,268175631,65014513,203161118,2014.csv,2014,24.2%,75.8%
384,Something's Gotta Give,265328738,124728738,140600000,2003.csv,2003,47%,53%
385,Bridget Jones: The Edge of Reason,265126918,40226215,224900703,2004.csv,2004,15.2%,84.8%
386,Charlie's Angels,264105545,125305545,138800000,2000.csv,2000,47.4%,52.6%
387,Robots,262511490,128200012,134311478,2005.csv,2005,48.8%,51.2%
388,Knight and Day 2010 Re-release,261930436,76423035,185507401,2010.csv,2010,29.2%,70.8%
389,Terminator: Dark Fate,261119292,62253077,198866215,2019.csv,2019,23.8%,76.2%
390,The Lone Ranger,260502115,89302115,171200000,2013.csv,2013,34.3%,65.7%
391,Super 8,260095986,127004179,133091807,2011.csv,2011,48.8%,51.2%
392,Xun long jue,259368448,1243810,258124638,2015.csv,2015,0.5%,99.5%
393,Blade Runner 2049,259239658,92054159,167185499,2017.csv,2017,35.5%,64.5%
394,Charlie's Angels: Full Throttle,259175788,100830111,158345677,2003.csv,2003,38.9%,61.1%
395,Kung Fu Yoga,257743016,362657,257380359,2017.csv,2017,0.1%,99.9%
396,Annabelle,257047661,84273813,172773848,2014.csv,2014,32.8%,67.2%
397,The Village,256697520,114197520,142500000,2003.csv,2003,44.5%,55.5%
398,Lost in Hong Kong,256283912,1302281,254981631,2015.csv,2015,0.5%,99.5%
399,Erin Brockovich,256271286,125595205,130676081,2000.csv,2000,49%,51%
400,Halloween,255485178,159342015,96143163,2018.csv,2018,62.4%,37.6%
401,Get Out,255407969,176040665,79367304,2017.csv,2017,68.9%,31.1%
402,Us,255184580,175084580,80100000,2019.csv,2019,68.6%,31.4%
403,Parasite,254255151,53369749,200885402,2019.csv,2019,21%,79%
404,Baahubali 2: The Conclusion,254158390,20186659,233971731,2017.csv,2017,7.9%,92.1%
405,Men in Black: International,253890701,80001807,173888894,2019.csv,2019,31.5%,68.5%
406,X-Men: Dark Phoenix,252442974,65845974,186597000,2019.csv,2019,26.1%,73.9%
407,True Grit,252276927,171243005,81033922,2010.csv,2010,67.9%,32.1%
408,American Hustle,251171807,150117807,101054000,2013.csv,2013,59.8%,40.2%
409,Brother Bear,250397798,85336277,165061521,2003.csv,2003,34.1%,65.9%
410,The Ring,249348933,129128133,120220800,2002.csv,2002,51.8%,48.2%
411,Unbreakable,248118121,95011339,153106782,2000.csv,2000,38.3%,61.7%
412,Journey to the West: The Demons Strike Back,247585244,880346,246704898,2017.csv,2017,0.4%,99.6%
413,Glass,246999039,111048468,135950571,2019.csv,2019,45%,55%
414,Grown Ups 2,246984278,133668525,113315753,2013.csv,2013,54.1%,45.9%
415,The Peanuts Movie,246233113,130178411,116054702,2015.csv,2015,52.9%,47.1%
416,Rango,245724603,123477607,122246996,2011.csv,2011,50.3%,49.7%
417,Teenage Mutant Ninja Turtles: Out of the Shadows,245623848,82051601,163572247,2016.csv,2016,33.4%,66.6%
418,Dark Shadows,245527149,79727149,165800000,2012.csv,2012,32.5%,67.5%
419,Hulk,245285165,132177234,113107931,2003.csv,2003,53.9%,46.1%
420,The Bravest,245179562,290217,244889345,2019.csv,2019,0.1%,99.9%
421,Love Actually,244931766,59696144,185235622,2003.csv,2003,24.4%,75.6%
422,Pixels,244874809,78747585,166127224,2015.csv,2015,32.2%,67.8%
423,Hercules,244819862,72688614,172131248,2014.csv,2014,29.7%,70.3%
424,After Earth,243611982,60522097,183089885,2013.csv,2013,24.8%,75.2%
425,8 Mile,242875078,116750901,126124177,2002.csv,2002,48.1%,51.9%
426,Daddy's Home,242786137,150357137,92429000,2015.csv,2015,61.9%,38.1%
427,RoboCop,242688965,58607007,184081958,2014.csv,2014,24.1%,75.9%
428,Alien: Covenant,240891763,74262031,166629732,2017.csv,2017,30.8%,69.2%
429,Sully,240797623,125070033,115727590,2016.csv,2016,51.9%,48.1%
430,Assassin's Creed,240697856,54647948,186049908,2016.csv,2016,22.7%,77.3%
431,Resident Evil: Retribution,240159255,42345531,197813724,2012.csv,2012,17.6%,82.4%
432,Planes,239258712,90288712,148970000,2013.csv,2013,37.7%,62.3%
433,Crazy Rich Asians,238532921,174532921,64000000,2018.csv,2018,73.2%,26.8%
434,Gulliver's Travels,237382724,42779261,194603463,2010.csv,2010,18%,82%
435,Gone in 60 Seconds,237202299,101648571,135553728,2000.csv,2000,42.9%,57.1%
436,Silver Linings Playbook,236412453,132092958,104319495,2012.csv,2012,55.9%,44.1%
437,2 Fast 2 Furious,236350661,127154901,109195760,2003.csv,2003,53.8%,46.2%
438,Hidden Figures,235956898,169607287,66349611,2016.csv,2016,71.9%,28.1%
439,A.I. Artificial Intelligence,235926552,78616689,157309863,2001.csv,2001,33.3%,66.7%
440,Spy,235666219,110825712,124840507,2015.csv,2015,47%,53%
441,Howl's Moving Castle,235347345,4711096,230636249,2004.csv,2004,2%,98%
442,American Reunion,234989584,57011521,177978063,2012.csv,2012,24.3%,75.7%
443,Alvin and the Chipmunks: The Road Chip,234798636,85886987,148911649,2015.csv,2015,36.6%,63.4%
444,The Imitation Game,233555708,91125683,142430025,2014.csv,2014,39%,61%
445,American Wedding,232722935,104565114,128157821,2003.csv,2003,44.9%,55.1%
446,The Girl with the Dragon Tattoo,232617430,102515793,130101637,2011.csv,2011,44.1%,55.9%
447,Argo,232325503,136025503,96300000,2012.csv,2012,58.5%,41.5%
448,Annabelle Comes Home,231252591,74152591,157100000,2019.csv,2019,32.1%,67.9%
449,Constantine,230884728,75976178,154908550,2005.csv,2005,32.9%,67.1%
450,The Heat,229930771,159582188,70348583,2013.csv,2013,69.4%,30.6%
451,Ghostbusters,229147509,128350574,100796935,2016.csv,2016,56%,44%
452,Goodbye Mr. Loser,228122928,1293626,226829302,2015.csv,2015,0.6%,99.4%
453,Paddington 2,227978523,40891591,187086932,2017.csv,2017,17.9%,82.1%
454,Dolittle,227908130,77047065,150861065,2020.csv,2020,33.8%,66.2%
455,The Green Hornet,227817248,98780042,129037206,2011.csv,2011,43.4%,56.6%
456,Youth,227091290,1891956,225199334,2017.csv,2017,0.8%,99.2%
457,Baby Driver,226945087,107825862,119119225,2017.csv,2017,47.5%,52.5%
458,Immortals,226904017,83504017,143400000,2011.csv,2011,36.8%,63.2%
459,Percy Jackson & the Olympians: The Lightning Thief,226497209,88768303,137728906,2010.csv,2010,39.2%,60.8%
460,Hansel & Gretel: Witch Hunters,226349749,55703475,170646274,2013.csv,2013,24.6%,75.4%
461,Valerian and the City of a Thousand Planets,225874228,41189488,184684740,2017.csv,2017,18.2%,81.8%
462,Ford v Ferrari,225508210,117624357,107883853,2019.csv,2019,52.2%,47.8%
463,Better Days,225320294,1921657,223398637,2019.csv,2019,0.9%,99.1%
464,The Social Network,224920315,96962694,127957621,2010.csv,2010,43.1%,56.9%
465,Chicken Run,224834564,106834564,118000000,2000.csv,2000,47.5%,52.5%
466,Flightplan,223387299,89707299,133680000,2005.csv,2005,40.2%,59.8%
467,Non-Stop,222809600,92168600,130641000,2014.csv,2014,41.4%,58.6%
468,Fahrenheit 9/11,222446882,119194771,103252111,2004.csv,2004,53.6%,46.4%
469,Geostorm,221600160,33700160,187900000,2017.csv,2017,15.2%,84.8%
470,Collateral,220926695,101005703,119920992,2004.csv,2004,45.7%,54.3%
471,Scary Movie 3,220673217,110003217,110670000,2003.csv,2003,49.8%,50.2%
472,Elf,220443451,173398518,47044933,2003.csv,2003,78.7%,21.3%
473,Inferno,220021259,34343574,185677685,2016.csv,2016,15.6%,84.4%
474,Green Lantern,219851172,116601172,103250000,2011.csv,2011,53%,47%
475,The Terminal,219100084,77872883,141227201,2004.csv,2004,35.5%,64.5%
476,Captain Phillips,218791811,107100855,111690956,2013.csv,2013,49%,51%
477,Jack Reacher,218340595,80070736,138269859,2012.csv,2012,36.7%,63.3%
478,Kingdom of Heaven,218122627,47398413,170724214,2005.csv,2005,21.7%,78.3%
479,The Emoji Movie,217776646,86089513,131687133,2017.csv,2017,39.5%,60.5%
480,Dracula Untold,217124280,56280355,160843925,2014.csv,2014,25.9%,74.1%
481,Central Intelligence,216972543,127440871,89531672,2016.csv,2016,58.7%,41.3%
482,Million Dollar Baby,216763646,100492203,116271443,2004.csv,2004,46.4%,53.6%
483,The Help,216639112,169708112,46931000,2011.csv,2011,78.3%,21.7%
484,Valentine's Day,216485654,110485654,106000000,2010.csv,2010,51%,49%
485,Bad Teacher,216197492,100292856,115904636,2011.csv,2011,46.4%,53.6%
486,Ted 2,215863606,81476385,134387221,2015.csv,2015,37.7%,62.3%
487,Vertical Limit,215663859,69243859,146420000,2000.csv,2000,32.1%,67.9%
488,The Patriot,215294342,113330342,101964000,2000.csv,2000,52.6%,47.4%
489,The Sorcerer's Apprentice,215283742,63150991,152132751,2010.csv,2010,29.3%,70.7%
490,Just Go with It,214945591,103028109,111917482,2011.csv,2011,47.9%,52.1%
491,The Expendables 3,214657577,39322544,175335033,2014.csv,2014,18.3%,81.7%
492,Creed II,214215889,115715889,98500000,2018.csv,2018,54%,46%
493,Smallfoot,214040103,83240103,130800000,2018.csv,2018,38.9%,61.1%
494,The Bourne Identity,214034224,121661683,92372541,2002.csv,2002,56.8%,43.2%
495,The Aviator,213719942,102610330,111109612,2004.csv,2004,48%,52%
496,"Crouching Tiger, Hidden Dragon",213525736,128078872,85446864,2000.csv,2000,60%,40%
497,Into the Woods,212902372,128002372,84900000,2014.csv,2014,60.1%,39.9%
498,Miss Congeniality,212742720,106807667,105935053,2000.csv,2000,50.2%,49.8%
499,Bridget Jones's Baby,211952420,24252420,187700000,2016.csv,2016,11.4%,88.6%
500,Battle Los Angeles,211819354,83552429,128266925,2011.csv,2011,39.4%,60.6%
501,Fury,211817906,85817906,126000000,2014.csv,2014,40.5%,59.5%
502,Due Date,211780824,100539043,111241781,2010.csv,2010,47.5%,52.5%
503,Master and Commander: The Far Side of the World,211622535,93927920,117694615,2003.csv,2003,44.4%,55.6%
504,Lemony Snicket's A Series of Unfortunate Events,211468235,118634549,92833686,2004.csv,2004,56.1%,43.9%
505,The Others,209947037,96522687,113424350,2001.csv,2001,46%,54%
506,Horrible Bosses,209838559,117538559,92300000,2011.csv,2011,56%,44%
507,Red Dragon,209196298,93149898,116046400,2002.csv,2002,44.5%,55.5%
508,Tomorrowland,209035668,93436322,115599346,2015.csv,2015,44.7%,55.3%
509,Me Before You,208314186,56245075,152069111,2016.csv,2016,27%,73%
510,Safe House,208076205,126373434,81702771,2012.csv,2012,60.7%,39.3%
511,S.W.A.T.,207725639,116934650,90790989,2003.csv,2003,56.3%,43.7%
512,Traffic,207515725,124115725,83400000,2000.csv,2000,59.8%,40.2%
513,The Fast and the Furious,207283925,144533925,62750000,2001.csv,2001,69.7%,30.3%
514,Paranormal Activity 3,207039844,104028807,103011037,2011.csv,2011,50.2%,49.8%
515,Little Women,206006503,108101214,97905289,2019.csv,2019,52.5%,47.5%
516,London Has Fallen,205754447,62524260,143230187,2016.csv,2016,30.4%,69.6%
517,Journey to the West,205637183,18058,205619125,2013.csv,2013,<0.1%,100%
518,White House Down,205366737,73103784,132262953,2013.csv,2013,35.6%,64.4%
519,A Dog's Purpose,205035819,64508620,140527199,2017.csv,2017,31.5%,68.5%
520,Fun with Dick and Jane,204681899,110332737,94349162,2005.csv,2005,53.9%,46.1%
521,Eat Pray Love,204594016,80574010,124020006,2010.csv,2010,39.4%,60.6%
522,King Arthur,203567857,51882244,151685613,2004.csv,2004,25.5%,74.5%
523,Yogi Bear,203518375,100246011,103272364,2010.csv,2010,49.3%,50.7%
524,Everest,203427584,43482270,159945314,2015.csv,2015,21.4%,78.6%
525,Vanilla Sky,203388341,100618344,102769997,2001.csv,2001,49.5%,50.5%
526,Arrival,203388186,100546139,102842047,2016.csv,2016,49.4%,50.6%
527,Need for Speed,203277636,43577636,159700000,2014.csv,2014,21.4%,78.6%
528,Garfield,203172417,75369589,127802828,2004.csv,2004,37.1%,62.9%
529,The Addams Family,203044905,100044905,103000000,2019.csv,2019,49.3%,50.7%
530,Birds of Prey: And the Fantabulous Emancipation of One Harley Quinn,201858461,84158461,117700000,2020.csv,2020,41.7%,58.3%
531,Straight Outta Compton,201634991,161197785,40437206,2015.csv,2015,79.9%,20.1%
532,21 Jump Street,201585328,138447667,63137661,2012.csv,2012,68.7%,31.3%
533,Cats & Dogs,200687492,93385515,107301977,2001.csv,2001,46.5%,53.5%
534,Percy Jackson: Sea of Monsters,199850315,68559554,131290761,2013.csv,2013,34.3%,65.7%
535,Two Weeks Notice,199043242,93354851,105688391,2002.csv,2002,46.9%,53.1%
536,RED,199006387,90380162,108626225,2010.csv,2010,45.4%,54.6%
537,The Pacifier,198636868,113086868,85550000,2005.csv,2005,56.9%,43.1%
538,50 First Dates,198520934,120908074,77612860,2004.csv,2004,60.9%,39.1%
539,Total Recall,198467168,58877969,139589199,2012.csv,2012,29.7%,70.3%
540,The Island,198326350,670883,197655467,2018.csv,2018,0.3%,99.7%
541,The Impossible,198087212,19019882,179067330,2012.csv,2012,9.6%,90.4%
542,Lost in Thailand,197757387,57387,197700000,2012.csv,2012,<0.1%,100%
543,Christopher Robin,197744377,99215042,98529335,2018.csv,2018,50.2%,49.8%
544,Jack the Giant Slayer,197687603,65187603,132500000,2013.csv,2013,33%,67%
545,Smurfs: The Lost Village,197183546,45020282,152163264,2017.csv,2017,22.8%,77.2%
546,Spy Kids 3-D: Game Over,197011982,111761982,85250000,2003.csv,2003,56.7%,43.3%
547,The Other Woman,196710396,83911193,112799203,2014.csv,2014,42.7%,57.3%
548,Panic Room,196397415,96397334,100000081,2002.csv,2002,49.1%,50.9%
549,The Vow,196114570,125014030,71100540,2012.csv,2012,63.7%,36.3%
550,Anger Management,195745823,135645823,60100000,2003.csv,2003,69.3%,30.7%
551,The Shape of Water,195333312,63859435,131473877,2017.csv,2017,32.7%,67.3%
552,The BFG,195243411,55483770,139759641,2016.csv,2016,28.4%,71.6%
553,Rocketman,195179299,96368160,98811139,2019.csv,2019,49.4%,50.6%
554,The Intern,194564672,75764672,118800000,2015.csv,2015,38.9%,61.1%
555,Wallace & Gromit: The Curse of the Were-Rabbit,194111171,56110897,138000274,2005.csv,2005,28.9%,71.1%
556,Gnomeo & Juliet,193967670,99967670,94000000,2011.csv,2011,51.5%,48.5%
557,The Sum of All Fears,193921372,118907036,75014336,2002.csv,2002,61.3%,38.7%
558,Gangs of New York,193772504,77812000,115960504,2002.csv,2002,40.2%,59.8%
559,The Monkey King 2,193678298,709982,192968316,2016.csv,2016,0.4%,99.6%
560,The Equalizer,192330738,101530738,90800000,2014.csv,2014,52.8%,47.2%
561,The Lego Movie 2: The Second Part,192306508,105806508,86500000,2019.csv,2019,55%,45%
562,Downton Abbey,192094429,96854135,95240294,2019.csv,2019,50.4%,49.6%
563,The Longest Yard,191466556,158119460,33347096,2005.csv,2005,82.6%,17.4%
564,The Equalizer 2,190400157,102084362,88315795,2018.csv,2018,53.6%,46.4%
565,Hollow Man,190213455,73209340,117004115,2000.csv,2000,38.5%,61.5%
566,Cheaper by the Dozen,190212113,138614544,51597569,2003.csv,2003,72.9%,27.1%
567,Abominable,189892513,60716390,129176123,2019.csv,2019,32%,68%
568,The White Storm 2: Drug Lords,189396380,609461,188786919,2019.csv,2019,0.3%,99.7%
569,Breakup Buddies,189017596,777896,188239700,2014.csv,2014,0.4%,99.6%
570,The Secret Life of Walter Mitty,188133322,58236838,129896484,2013.csv,2013,31%,69%
571,12 Years a Slave,187733202,56671993,131061209,2013.csv,2013,30.2%,69.8%
572,Mr. Popper's Penguins,187361754,68224452,119137302,2011.csv,2011,36.4%,63.6%
573,The Grudge,187281115,110359362,76921753,2004.csv,2004,58.9%,41.1%
574,Weathering with You,186921054,7798743,179122311,2019.csv,2019,4.2%,95.8%
575,Walk the Line,186797986,119519402,67278584,2005.csv,2005,64%,36%
576,Atlantis: The Lost Empire,186053725,84056472,101997253,2001.csv,2001,45.2%,54.8%
577,Hugo,185770160,73864507,111905653,2011.csv,2011,39.8%,60.2%
578,The Lion King 2011 3D Release,185542001,94242001,91300000,2011.csv,2011,50.8%,49.2%
579,Pitch Perfect 3,185400345,104897530,80502815,2017.csv,2017,56.6%,43.4%
580,Hop,183953723,108085305,75868418,2011.csv,2011,58.8%,41.2%
581,Bad Moms,183936074,113257297,70678777,2016.csv,2016,61.6%,38.4%
582,Jupiter Ascending,183887723,47387723,136500000,2015.csv,2015,25.8%,74.2%
583,102 Dalmatians,183611771,66957026,116654745,2000.csv,2000,36.5%,63.5%
584,Storks,183388953,72679278,110709675,2016.csv,2016,39.6%,60.4%
585,Mirror Mirror,183018522,64935167,118083355,2012.csv,2012,35.5%,64.5%
586,The Haunted Mansion,182290266,75847266,106443000,2003.csv,2003,41.6%,58.4%
587,Scooby-Doo 2: Monsters Unleashed,181216833,84216833,97000000,2004.csv,2004,46.5%,53.5%
588,Road to Perdition,181001478,104454762,76546716,2002.csv,2002,57.7%,42.3%
589,Kill Bill: Vol. 1,180899045,70099045,110800000,2003.csv,2003,38.8%,61.2%
590,The Hitman's Bodyguard,180650747,75468583,105182164,2017.csv,2017,41.8%,58.2%
591,Sweet Home Alabama,180622424,127223418,53399006,2002.csv,2002,70.4%,29.6%
592,Daddy's Home 2,180613180,104029443,76583737,2017.csv,2017,57.6%,42.4%
593,Hacksaw Ridge,180450918,67209615,113241303,2016.csv,2016,37.2%,62.8%
594,The Post,179769457,81903458,97865999,2017.csv,2017,45.6%,54.4%
595,The Dictator,179379533,59650222,119729311,2012.csv,2012,33.3%,66.7%
596,The League of Extraordinary Gentlemen,179265204,66465204,112800000,2003.csv,2003,37.1%,62.9%
597,Allegiant,179246868,66184051,113062817,2016.csv,2016,36.9%,63.1%
598,Moulin Rouge!,179213434,57386607,121826827,2001.csv,2001,32%,68%
599,Daredevil,179179718,102543518,76636200,2003.csv,2003,57.2%,42.8%
600,The Scorpion King,178799308,91047077,87752231,2002.csv,2002,50.9%,49.1%
601,Along Came Polly,178311729,88097164,90214565,2004.csv,2004,49.4%,50.6%
602,Brokeback Mountain,178062759,83043761,95018998,2005.csv,2005,46.6%,53.4%
603,Baywatch,177856751,58060186,119796565,2017.csv,2017,32.6%,67.4%
604,War Horse,177584879,79884879,97700000,2011.csv,2011,45%,55%
605,Paranormal Activity 2,177512032,84752907,92759125,2010.csv,2010,47.7%,52.3%
606,How to Lose a Guy in 10 Days,177502387,105813373,71689014,2003.csv,2003,59.6%,40.4%
607,Alien vs. Predator,177427090,80282231,97144859,2004.csv,2004,45.2%,54.8%
608,Hero,177395557,53710019,123685538,2002.csv,2002,30.3%,69.7%
609,The 40-Year-Old Virgin,177378645,109449237,67929408,2005.csv,2005,61.7%,38.3%
610,Lee Daniels' The Butler,177313795,116632095,60681700,2013.csv,2013,65.8%,34.2%
611,The Descendants,177243185,82584160,94659025,2011.csv,2011,46.6%,53.4%
612,The A-Team,177238796,77222099,100016697,2010.csv,2010,43.6%,56.4%
613,Looper,176506819,66486205,110020614,2012.csv,2012,37.7%,62.3%
614,Dr. Dolittle 2,176104344,112952899,63151445,2001.csv,2001,64.1%,35.9%
615,The Italian Job,176070171,106128601,69941570,2003.csv,2003,60.3%,39.7%
616,Cowboys & Aliens,174822325,100240551,74581774,2011.csv,2011,57.3%,42.7%
617,The Mule,174804407,103804407,71000000,2018.csv,2018,59.4%,40.6%
618,Identity Thief,173965010,134506920,39458090,2013.csv,2013,77.3%,22.7%
619,The Nutcracker and the Four Realms,173961069,54858851,119102218,2018.csv,2018,31.5%,68.5%
620,Big Momma's House,173959438,117559438,56400000,2000.csv,2000,67.6%,32.4%
621,In Time,173930596,37520095,136410501,2011.csv,2011,21.6%,78.4%
622,Amélie,173921954,33225499,140696455,2001.csv,2001,19.1%,80.9%
623,Operation Mekong,173839072,800012,173039060,2016.csv,2016,0.5%,99.5%
624,Creed,173567581,109767581,63800000,2015.csv,2015,63.2%,36.8%
625,Gemini Man,173469516,48546770,124922746,2019.csv,2019,28%,72%
626,The Girl on the Train,173185859,75395035,97790824,2016.csv,2016,43.5%,56.5%
627,Cold Mountain,173013509,95636509,77377000,2003.csv,2003,55.3%,44.7%
628,Black Hawk Down,172989651,108638745,64350906,2001.csv,2001,62.8%,37.2%
629,The Grand Budapest Hotel,172936941,59301324,113635617,2014.csv,2014,34.3%,65.7%
630,The Santa Clause 2,172855065,139236327,33618738,2002.csv,2002,80.6%,19.4%
631,Jackass 3D,171685792,117229692,54456100,2010.csv,2010,68.3%,31.7%
632,Spies in Disguise,171616764,66757013,104859751,2019.csv,2019,38.9%,61.1%
633,John Wick: Chapter 2,171539887,92029184,79510703,2017.csv,2017,53.6%,46.4%
634,Anchorman 2: The Legend Continues,171464676,125168368,46296308,2013.csv,2013,73%,27%
635,Mr. Deeds,171269535,126293452,44976083,2002.csv,2002,73.7%,26.3%
636,The Other Guys,170458922,119219978,51238944,2010.csv,2010,69.9%,30.1%
637,Olympus Has Fallen,170270201,98925640,71344561,2013.csv,2013,58.1%,41.9%
638,Starsky & Hutch,170268750,88237754,82030996,2004.csv,2004,51.8%,48.2%
639,Shall We Dance,170128460,57890460,112238000,2004.csv,2004,34%,66%
640,Stuart Little 2,169956806,64956806,105000000,2002.csv,2002,38.2%,61.8%
641,Zookeeper,169852759,80360843,89491916,2011.csv,2011,47.3%,52.7%
642,Dumb and Dumber To,169837010,86208010,83629000,2014.csv,2014,50.8%,49.2%
643,Ghost in the Shell,169801921,40563557,129238364,2017.csv,2017,23.9%,76.1%
644,The Emperor's New Groove,169327687,89302687,80025000,2000.csv,2000,52.7%,47.3%
645,Dodgeball: A True Underdog Story,168423227,114326736,54096491,2004.csv,2004,67.9%,32.1%
646,Insidious: The Last Key,167885588,67745330,100140258,2018.csv,2018,40.4%,59.6%
647,Fantastic Four,167882881,56117548,111765333,2015.csv,2015,33.4%,66.6%
648,Unstoppable,167805466,81562942,86242524,2010.csv,2010,48.6%,51.4%
649,Magic Mike,167739368,113721571,54017797,2012.csv,2012,67.8%,32.2%
650,Alexander,167298192,34297191,133001001,2004.csv,2004,20.5%,79.5%
651,Nutty Professor II: The Klumps,166339890,123309890,43030000,2000.csv,2000,74.1%,25.9%
652,Bridge of Spies,165478348,72313754,93164594,2015.csv,2015,43.7%,56.3%
653,The Princess Diaries,165335153,108248956,57086197,2001.csv,2001,65.5%,34.5%
654,The Muppets,165184237,88631237,76553000,2011.csv,2011,53.7%,46.3%
655,The Huntsman: Winter's War,164989338,48390190,116599148,2016.csv,2016,29.3%,70.7%
656,Bringing Down the House,164729679,132716677,32013002,2003.csv,2003,80.6%,19.4%
657,Daddy Day Care,164433867,104297061,60136806,2003.csv,2003,63.4%,36.6%
658,The Ring Two,163995949,76231249,87764700,2005.csv,2005,46.5%,53.5%
659,The Island,162949164,35818913,127130251,2005.csv,2005,22%,78%
660,The Interpreter,162944923,72708161,90236762,2005.csv,2005,44.6%,55.4%
661,The Magnificent Seven,162360636,93432655,68927981,2016.csv,2016,57.5%,42.5%
662,Memoirs of a Geisha,162242962,57490508,104752454,2005.csv,2005,35.4%,64.6%
663,Jack Reacher: Never Go Back,162146076,58697076,103449000,2016.csv,2016,36.2%,63.8%
664,Insidious: Chapter 2,161919318,83586447,78332871,2013.csv,2013,51.6%,48.4%
665,Limitless,161849455,79249455,82600000,2011.csv,2011,49%,51%
666,Scream 3,161834276,89143175,72691101,2000.csv,2000,55.1%,44.9%
667,Flight,161772375,93772375,68000000,2012.csv,2012,58%,42%
668,Into the Storm,161502194,47602194,113900000,2014.csv,2014,29.5%,70.5%
669,Unbroken,161459297,115637895,45821402,2014.csv,2014,71.6%,28.4%
670,Freaky Friday,160846332,110230332,50616000,2003.csv,2003,68.5%,31.5%
671,The Predator,160542134,51024708,109517426,2018.csv,2018,31.8%,68.2%
672,Johnny English,160466000,28082366,132383634,2003.csv,2003,17.5%,82.5%
673,"Three Billboards Outside Ebbing, Missouri",160192031,54513740,105678291,2017.csv,2017,34%,66%
674,Underworld Awakening,160112671,62321039,97791632,2012.csv,2012,38.9%,61.1%
675,Lara Croft Tomb Raider: The Cradle of Life,160099222,65660196,94439026,2003.csv,2003,41%,59%
676,Johnny English Reborn,160078586,8305970,151772616,2011.csv,2011,5.2%,94.8%
677,Step Up 3D,159291809,42400223,116891586,2010.csv,2010,26.6%,73.4%
678,Happy Feet Two,159196259,64006466,95189793,2011.csv,2011,40.2%,59.8%
679,Johnny English Strikes Again,158970776,4412170,154558606,2018.csv,2018,2.8%,97.2%
680,Focus,158762963,53862963,104900000,2015.csv,2015,33.9%,66.1%
681,Sin City,158733820,74103820,84630000,2005.csv,2005,46.7%,53.3%
682,Goosebumps,158260952,80080379,78180573,2015.csv,2015,50.6%,49.4%
683,Final Destination 5,157887643,42587643,115300000,2011.csv,2011,27%,73%
684,Don't Breathe,157830487,89217875,68612612,2016.csv,2016,56.5%,43.5%
685,Hustlers,157563598,104963598,52600000,2019.csv,2019,66.6%,33.4%
686,The Book of Eli,157107755,94835059,62272696,2010.csv,2010,60.4%,39.6%
687,Ip Man 3,156954938,2679437,154275501,2015.csv,2015,1.7%,98.3%
688,The Climbers,156759167,487157,156272010,2019.csv,2019,0.3%,99.7%
689,Mystic River,156595191,90135191,66460000,2003.csv,2003,57.6%,42.4%
690,This Means War,156491279,54760791,101730488,2012.csv,2012,35%,65%
691,The Hateful Eight,155760117,54117416,101642701,2015.csv,2015,34.7%,65.3%
692,Escape Room,155712077,57005601,98706476,2019.csv,2019,36.6%,63.4%
693,The Monuments Men,155641650,78031620,77610030,2014.csv,2014,50.1%,49.9%
694,Monster-in-Law,155457327,82931301,72526026,2005.csv,2005,53.3%,46.7%
695,The Accountant,155160045,86260045,68900000,2016.csv,2016,55.6%,44.4%
696,Blade II,155010032,82348319,72661713,2002.csv,2002,53.1%,46.9%
697,Maid in Manhattan,154906693,94011225,60895468,2002.csv,2002,60.7%,39.3%
698,Lone Survivor,154802912,125095601,29707311,2013.csv,2013,80.8%,19.2%
699,The Angry Birds Movie 2,154692886,41667116,113025770,2019.csv,2019,26.9%,73.1%
700,The Phantom of the Opera,154648887,51268815,103380072,2004.csv,2004,33.2%,66.8%
701,Ride Along,154468902,134938200,19530702,2014.csv,2014,87.4%,12.6%
702,Kill Bill: Vol. 2,154116796,66208183,87908613,2004.csv,2004,43%,57%
703,The Town,154026136,92186262,61839874,2010.csv,2010,59.9%,40.1%
704,Midnight in Paris,153887576,56817045,97070531,2011.csv,2011,36.9%,63.1%
705,Yesterday,153712841,73286650,80426191,2019.csv,2019,47.7%,52.3%
706,Tower Heist,152930623,78046570,74884053,2011.csv,2011,51%,49%
707,Duckweed,152894264,471575,152422689,2017.csv,2017,0.3%,99.7%
708,Chocolat,152699946,71509363,81190583,2000.csv,2000,46.8%,53.2%
709,Date Night,152263880,98711404,53552476,2010.csv,2010,64.8%,35.2%
710,Bad Grandpa,151826547,102003019,49823528,2013.csv,2013,67.2%,32.8%
711,47 Ronin,151783839,38362475,113421364,2013.csv,2013,25.3%,74.7%
712,Red Sparrow,151572634,46874505,104698129,2018.csv,2018,30.9%,69.1%
713,Darkest Hour,150847207,56468410,94378797,2017.csv,2017,37.4%,62.6%
714,Gods of Egypt,150680864,31153464,119527400,2015.csv,2015,20.7%,79.3%
715,I Am Number Four,149878437,55100437,94778000,2011.csv,2011,36.8%,63.2%
716,Jack and Jill,149673788,74158157,75515631,2011.csv,2011,49.5%,50.5%
717,Friends with Benefits,149542245,55802754,93739491,2011.csv,2011,37.3%,62.7%
718,"Me, Myself & Irene",149270999,90570999,58700000,2000.csv,2000,60.7%,39.3%
719,No Strings Attached,149228077,70662220,78565857,2011.csv,2011,47.4%,52.6%
720,Lights Out,148868835,67268835,81600000,2016.csv,2016,45.2%,54.8%
721,The Secret World of Arrietty,148800274,19202743,129597531,2010.csv,2010,12.9%,87.1%
722,King Arthur: Legend of the Sword,148675066,39175066,109500000,2017.csv,2017,26.3%,73.7%
723,Seabiscuit,148336445,120277854,28058591,2003.csv,2003,81.1%,18.9%
724,RED 2,148075565,53262560,94813005,2013.csv,2013,36%,64%
725,Spy Kids,147934180,112719001,35215179,2001.csv,2001,76.2%,23.8%
726,The Mexican,147845033,66845033,81000000,2001.csv,2001,45.2%,54.8%
727,Saw II,147748505,87039965,60708540,2005.csv,2005,58.9%,41.1%
728,Angel Has Fallen,147501990,69030436,78471554,2019.csv,2019,46.8%,53.2%
729,Arthur Christmas,147419472,46462469,100957003,2011.csv,2011,31.5%,68.5%
730,Source Code,147332697,54712227,92620470,2011.csv,2011,37.1%,62.9%
731,Swordfish,147080413,69772969,77307444,2001.csv,2001,47.4%,52.6%
732,Planes: Fire & Rescue,146965787,59165787,87800000,2014.csv,2014,40.3%,59.7%
733,The Last Witch Hunter,146936910,27367660,119569250,2015.csv,2015,18.6%,81.4%
734,Mama,146428180,71628180,74800000,2013.csv,2013,48.9%,51.1%
735,The Foreigner,145374099,34393507,110980592,2017.csv,2017,23.7%,76.3%
736,Home on the Range,145358062,50030461,95327601,2004.csv,2004,34.4%,65.6%
737,The Exorcism of Emily Rose,145166804,75072454,70094350,2005.csv,2005,51.7%,48.3%
738,"Crazy, Stupid, Love.",145051197,84351197,60700000,2011.csv,2011,58.2%,41.8%
739,Herbie Fully Loaded,144146816,66023816,78123000,2005.csv,2005,45.8%,54.2%
740,The Beach,144056873,39785027,104271846,2000.csv,2000,27.6%,72.4%
741,Pete's Dragon,143695338,76233151,67462187,2016.csv,2016,53.1%,46.9%
742,Spy Game,143049560,62362560,80687000,2001.csv,2001,43.6%,56.4%
743,More Than Blue,142958164,722669,142235495,2018.csv,2018,0.5%,99.5%
744,Paranormal Activity 4,142802657,53885000,88917657,2012.csv,2012,37.7%,62.3%
745,The Legend of Zorro,142400065,46464023,95936042,2005.csv,2005,32.6%,67.4%
746,Power Rangers,142337240,85364450,56972790,2017.csv,2017,60%,40%
747,New Year's Eve,142044638,54544638,87500000,2011.csv,2011,38.4%,61.6%
748,Legally Blonde,141774679,96520674,45254005,2001.csv,2001,68.1%,31.9%
749,The Taking of Tiger Mountain,141654055,228984,141425071,2014.csv,2014,0.2%,99.8%
750,Gothika,141591324,59694580,81896744,2003.csv,2003,42.2%,57.8%
751,Mona Lisa Smile,141337989,63860942,77477047,2003.csv,2003,45.2%,54.8%
752,Scary Movie 2,141220678,71308997,69911681,2001.csv,2001,50.5%,49.5%
753,Shallow Hal,141069860,70839203,70230657,2001.csv,2001,50.2%,49.8%
754,Trainwreck,140795793,110212700,30583093,2015.csv,2015,78.3%,21.7%
755,Sausage Party,140705322,97685686,43019636,2016.csv,2016,69.4%,30.6%
756,Girls Trip,140552359,115171585,25380774,2017.csv,2017,81.9%,18.1%
757,Step Up Revolution,140470746,35074677,105396069,2012.csv,2012,25%,75%
758,Lion,140312928,51738905,88574023,2016.csv,2016,36.9%,63.1%
759,The SpongeBob SquarePants Movie,140192993,85417988,54775005,2004.csv,2004,60.9%,39.1%
760,Legend of the Guardians: The Owls of Ga'Hoole,140073390,55675313,84398077,2010.csv,2010,39.7%,60.3%
761,The Wolfman,139789765,61979680,77810085,2010.csv,2010,44.3%,55.7%
762,Mr. Six,139191345,1415450,137775895,2015.csv,2015,1%,99%
763,The Admiral,138342258,2589811,135752447,2014.csv,2014,1.9%,98.1%
764,America's Sweethearts,138307673,93607673,44700000,2001.csv,2001,67.7%,32.3%
765,Let's Be Cops,138224951,82390774,55834177,2014.csv,2014,59.6%,40.4%
766,Escape Plan,137328301,25135965,112192336,2013.csv,2013,18.3%,81.7%
767,The First Purge,137056262,69488745,67567517,2018.csv,2018,50.7%,49.3%
768,Annie,136853506,85911262,50942244,2014.csv,2014,62.8%,37.2%
769,The Best Exotic Marigold Hotel,136836156,46412041,90424115,2012.csv,2012,33.9%,66.1%
770,How Long Will I Love U,136796719,746933,136049786,2018.csv,2018,0.5%,99.5%
771,Remember the Titans,136706683,115654751,21051932,2000.csv,2000,84.6%,15.4%
772,Contagion,136515867,75658097,60857770,2011.csv,2011,55.4%,44.6%
773,The Wind Rises,136454220,5209580,131244640,2012.csv,2012,3.8%,96.2%
774,The Bounty Hunter,136333522,67061228,69272294,2010.csv,2010,49.2%,50.8%
775,Saw: The Final Chapter,136150434,45710178,90440256,2010.csv,2010,33.6%,66.4%
776,Unknown,135710029,63686397,72023632,2011.csv,2011,46.9%,53.1%
777,The Jungle Book 2,135703599,47901582,87802017,2003.csv,2003,35.3%,64.7%
778,Jack Ryan: Shadow Recruit,135503748,50577412,84926336,2014.csv,2014,37.3%,62.7%
779,American Made,134866593,51342000,83524593,2017.csv,2017,38.1%,61.9%
780,Wall Street: Money Never Sleeps,134748021,52474616,82273405,2010.csv,2010,38.9%,61.1%
781,The Princess Diaries 2: Royal Engagement,134734481,95170481,39564000,2004.csv,2004,70.6%,29.4%
782,Last Vegas,134402450,63914167,70488283,2012.csv,2012,47.6%,52.4%
783,The Cat in the Hat,133960541,101149285,32811256,2003.csv,2003,75.5%,24.5%
784,Pokémon the Movie 2000,133949270,43758684,90190586,2000.csv,2000,32.7%,67.3%
785,Point Break,133718711,28782481,104936230,2015.csv,2015,21.5%,78.5%
786,The Big Short,133440870,70259870,63181000,2015.csv,2015,52.7%,47.3%
787,The Artist,133432856,44671682,88761174,2011.csv,2011,33.5%,66.5%
788,Zero Dark Thirty,132820716,95720716,37100000,2012.csv,2012,72.1%,27.9%
789,Ad Astra,132807427,50188370,82619057,2019.csv,2019,37.8%,62.2%
790,A Wrinkle in Time,132675864,100478608,32197256,2018.csv,2018,75.7%,24.3%
791,Ghost Rider: Spirit of Vengeance,132563930,51774002,80789928,2012.csv,2012,39.1%,60.9%
792,The Three Musketeers,132274484,20374484,111900000,2011.csv,2011,15.4%,84.6%
793,Blade: Trinity,131977904,52411906,79565998,2004.csv,2004,39.7%,60.3%
794,2 Guns,131940411,75612460,56327951,2013.csv,2013,57.3%,42.7%
795,Save the Last Dance,131706809,91057006,40649803,2001.csv,2001,69.1%,30.9%
796,The House with a Clock in Its Walls,131457147,68549695,62907452,2018.csv,2018,52.1%,47.9%
797,Bewitched,131426169,63313159,68113010,2005.csv,2005,48.2%,51.8%
798,School of Rock,131095614,81261177,49834437,2003.csv,2003,62%,38%
799,Munich,130982129,47403685,83578444,2005.csv,2005,36.2%,63.8%
800,Man on Fire,130834852,77911774,52923078,2004.csv,2004,59.5%,40.5%
801,A Bad Moms Christmas,130560428,72110659,58449769,2017.csv,2017,55.2%,44.8%
802,About a Boy,130549455,41385278,89164177,2002.csv,2002,31.7%,68.3%
803,Cloud Atlas,130482868,27108272,103374596,2012.csv,2012,20.8%,79.2%
804,Cheaper by the Dozen 2,130154568,82571173,47583395,2005.csv,2005,63.4%,36.6%
805,Mean Girls,130125829,86058055,44067774,2004.csv,2004,66.1%,33.9%
806,Resident Evil: Apocalypse,129342769,51201453,78141316,2004.csv,2004,39.6%,60.4%
807,The Woman in Black,128955898,54333290,74622608,2012.csv,2012,42.1%,57.9%
808,Space Cowboys,128884132,90464773,38419359,2000.csv,2000,70.2%,29.8%
809,Pan,128388320,35088320,93300000,2015.csv,2015,27.3%,72.7%
810,Space Station 3D,128363881,93383953,34979928,2002.csv,2002,72.7%,27.3%
811,Blended,127994610,46294610,81700000,2014.csv,2014,36.2%,63.8%
812,The Adjustment Bureau,127869379,62495645,65373734,2010.csv,2010,48.9%,51.1%
813,U-571,127666415,77122415,50544000,2000.csv,2000,60.4%,39.6%
814,March of the Penguins,127392693,77437223,49955470,2005.csv,2005,60.8%,39.2%
815,Predators,127233108,52000688,75232420,2010.csv,2010,40.9%,59.1%
816,Chronicle,126636097,64575175,62060922,2012.csv,2012,51%,49%
817,Walking with Dinosaurs 3D,126546518,36076121,90470397,2012.csv,2012,28.5%,71.5%
818,Sex Tape,126069509,38543473,87526036,2014.csv,2014,30.6%,69.4%
819,This Is the End,126041322,101470202,24571120,2013.csv,2013,80.5%,19.5%
820,The Upside,125852517,108252517,17600000,2019.csv,2019,86%,14%
821,Detective Chinatown,125842935,474252,125368683,2015.csv,2015,0.4%,99.6%
822,Wolf Totem,125837070,210591,125626479,2015.csv,2015,0.2%,99.8%
823,Mechanic: Resurrection,125729635,21218403,104511232,2016.csv,2016,16.9%,83.1%
824,Midway,125675266,56846802,68828464,2019.csv,2019,45.2%,54.8%
825,Ender's Game,125544024,61737191,63806833,2013.csv,2013,49.2%,50.8%
826,Happy Death Day,125479266,55683845,69795421,2017.csv,2017,44.4%,55.6%
827,Captain Underpants: The First Epic Movie,125427681,73921000,51506681,2017.csv,2017,58.9%,41.1%
828,"Legally Blonde 2: Red, White & Blonde",124914842,90186328,34728514,2003.csv,2003,72.2%,27.8%
829,The Family Man,124745083,75793305,48951778,2000.csv,2000,60.8%,39.2%
830,Ride Along 2,124605297,91221830,33383467,2015.csv,2015,73.2%,26.8%
831,The Invisible Man,124549496,64914050,59635446,2020.csv,2020,52.1%,47.9%
832,Ray,123971376,75331600,48639776,2004.csv,2004,60.8%,39.2%
833,The Time Machine,123729176,56832494,66896682,2002.csv,2002,45.9%,54.1%
834,The Theory of Everything,123726688,35893537,87833151,2014.csv,2014,29%,71%
835,Nanny McPhee,123276807,47144110,76132697,2005.csv,2005,38.2%,61.8%
836,Big Fish,123218424,66809693,56408731,2003.csv,2003,54.2%,45.8%
837,Hide and Seek,123204920,51100486,72104434,2005.csv,2005,41.5%,58.5%
838,The Curse of la Llorona,123133739,54733739,68400000,2019.csv,2019,44.5%,55.5%
839,The Lego Ninjago Movie,123081555,59281555,63800000,2017.csv,2017,48.2%,51.8%
840,The Pirates! Band of Misfits,123054041,31051126,92002915,2012.csv,2012,25.2%,74.8%
841,Looking Up,122994583,84267,122910316,2019.csv,2019,<0.1%,99.9%
842,Zombieland: Double Tap,122810399,73123082,49687317,2019.csv,2019,59.5%,40.5%
843,Dragon Blade,122593849,74068,122519781,2015.csv,2015,<0.1%,99.9%
844,Spirit: Stallion of the Cimarron,122563539,73280117,49283422,2002.csv,2002,59.8%,40.2%
845,Prisoners,122126687,61002302,61124385,2013.csv,2013,50%,50%
846,Secret Superstar,122026260,0,122026260,2017.csv,2017,-,100%
847,Extreme Job,121978657,1565885,120412772,2019.csv,2019,1.3%,98.7%
848,Peter Pan,121975011,48462608,73512403,2003.csv,2003,39.7%,60.3%
849,Deepwater Horizon,121790373,61433527,60356846,2016.csv,2016,50.4%,49.6%
850,Pride & Prejudice,121616555,38405088,83211467,2005.csv,2005,31.6%,68.4%
851,Last Christmas,121550750,35150750,86400000,2019.csv,2019,28.9%,71.1%
852,The Nut Job,120885527,64251541,56633986,2014.csv,2014,53.2%,46.8%
853,Intolerable Cruelty,120801243,35327628,85473615,2003.csv,2003,29.2%,70.8%
854,Dora and the Lost City of Gold,120624994,60477943,60147051,2019.csv,2019,50.1%,49.9%
855,Instant Family,120556201,67363237,53192964,2018.csv,2018,55.9%,44.1%
856,We Bought a Zoo,120081841,75624550,44457291,2011.csv,2011,63%,37%
857,The Pianist,120072577,32572577,87500000,2002.csv,2002,27.1%,72.9%
858,The Commuter,119942387,36343858,83598529,2017.csv,2017,30.3%,69.7%
859,Parental Guidance,119772232,77267296,42504936,2012.csv,2012,64.5%,35.5%
860,Road Trip,119754278,68540777,51213501,2000.csv,2000,57.2%,42.8%
861,Spy Kids 2: Island of Lost Dreams,119723358,85846429,33876929,2002.csv,2002,71.7%,28.3%
862,Wonder Park,119559110,45216793,74342317,2019.csv,2019,37.8%,62.2%
863,Allied,119520023,40098064,79421959,2016.csv,2016,33.5%,66.5%
864,Sahara,119240351,68671925,50568426,2005.csv,2005,57.6%,42.4%
865,Unfaithful,119137784,52775765,66362019,2002.csv,2002,44.3%,55.7%
866,I Belonged to You,119107580,744541,118363039,2016.csv,2016,0.6%,99.4%
867,The Shallows,119100758,55124043,63976715,2016.csv,2016,46.3%,53.7%
868,Lost in Translation,118685453,44585453,74100000,2003.csv,2003,37.6%,62.4%
869,The Purge: Election Year,118587880,79213375,39374505,2016.csv,2016,66.8%,33.2%
870,Jurassic Park 2013 Re-release,118192315,45385935,72806380,2013.csv,2013,38.4%,61.6%
871,A Cool Fish,118153135,551876,117601259,2018.csv,2018,0.5%,99.5%
872,Why Him?,118102725,60323786,57778939,2016.csv,2016,51.1%,48.9%
873,Corpse Bride,118090836,53359111,64731725,2005.csv,2005,45.2%,54.8%
874,P Storm,117991727,326711,117665016,2019.csv,2019,0.3%,99.7%
875,Saving Mr. Banks,117867984,83301580,34566404,2013.csv,2013,70.7%,29.3%
876,Pompeii,117831631,23219748,94611883,2014.csv,2014,19.7%,80.3%
877,Magic Mike XXL,117813057,66013057,51800000,2015.csv,2015,56%,44%
878,The Gentlemen,117769345,36296853,81472492,2020.csv,2020,30.8%,69.2%
879,Game Night,117679066,69179066,48500000,2018.csv,2018,58.8%,41.2%
880,The Forgotten,117592831,67133509,50459322,2004.csv,2004,57.1%,42.9%
881,A Knight's Tale,117487473,56569702,60917771,2001.csv,2001,48.1%,51.9%
882,Paycheck,117248958,53790451,63458507,2003.csv,2003,45.9%,54.1%
883,Water for Elephants,117094902,58709717,58385185,2011.csv,2011,50.1%,49.9%
884,Warm Bodies,116980662,66380662,50600000,2013.csv,2013,56.7%,43.3%
885,Finding Neverland,116650613,51680613,64970000,2004.csv,2004,44.3%,55.7%
886,Freddy vs. Jason,116632628,82622655,34009973,2003.csv,2003,70.8%,29.2%
887,Abraham Lincoln: Vampire Hunter,116471580,37519139,78952441,2012.csv,2012,32.2%,67.8%
888,The Notebook,116144526,81001787,35142739,2004.csv,2004,69.7%,30.3%
889,Personal Tailor,116126458,375892,115750566,2013.csv,2013,0.3%,99.7%
890,The Chronicles of Riddick,115900534,57761012,58139522,2004.csv,2004,49.8%,50.2%
891,The Iron Lady,115890699,30017992,85872707,2011.csv,2011,25.9%,74.1%
892,A Nightmare on Elm Street,115694863,63075011,52619852,2010.csv,2010,54.5%,45.5%
893,Dragon Ball Super: Broly,115560610,30712119,84848491,2018.csv,2018,26.6%,73.4%
894,Closer,115505027,33987757,81517270,2004.csv,2004,29.4%,70.6%
895,Pitch Perfect,115350426,65001093,50349333,2012.csv,2012,56.4%,43.6%
896,The Monkey King 3,115084576,187074,114897502,2018.csv,2018,0.2%,99.8%
897,Snow Dogs,115035090,81172560,33862530,2002.csv,2002,70.6%,29.4%
898,Dear John,114984666,80014842,34969824,2010.csv,2010,69.6%,30.4%
899,So Young,114926694,11186,114915508,2013.csv,2013,<0.1%,100%
900,Finding Mr Right 2,114679097,0,114679097,2016.csv,2016,-,100%
901,We Were Soldiers,114660784,78122718,36538066,2002.csv,2002,68.1%,31.9%
902,Office Christmas Party,114501299,54767494,59733805,2016.csv,2016,47.8%,52.2%
903,Hope Springs,114281051,63536011,50745040,2012.csv,2012,55.6%,44.4%
904,The Score,114252154,71107711,43144443,2001.csv,2001,62.2%,37.8%
905,Seventh Son,114178613,17223265,96955348,2014.csv,2014,15.1%,84.9%
906,Coyote Ugly,113916474,60786269,53130205,2000.csv,2000,53.4%,46.6%
907,Insomnia,113714830,67355513,46359317,2002.csv,2002,59.2%,40.8%
908,The Dark Tower,113231078,50701325,62529753,2017.csv,2017,44.8%,55.2%
909,Pet Sematary,113118226,54724696,58393530,2019.csv,2019,48.4%,51.6%
910,White Chicks,113100873,70831760,42269113,2004.csv,2004,62.6%,37.4%
911,Insidious: Chapter 3,112983889,52218558,60765331,2015.csv,2015,46.2%,53.8%
912,Final Destination,112880294,53331147,59549147,2000.csv,2000,47.2%,52.8%
913,Cats & Dogs: The Revenge of Kitty Galore,112483764,43585753,68898011,2010.csv,2010,38.7%,61.3%
914,Tooth Fairy,112462508,60022256,52440252,2010.csv,2010,53.4%,46.6%
915,How to Be Single,112343513,46843513,65500000,2016.csv,2016,41.7%,58.3%
916,The Exorcist 2000 Director's Cut,112053066,39671011,72382055,2000.csv,2000,35.4%,64.6%
917,The Purge: Anarchy,111928365,71962800,39965565,2014.csv,2014,64.3%,35.7%
918,Get Hard,111711453,90411453,21300000,2015.csv,2015,80.9%,19.1%
919,The Dukes of Hazzard,111069515,80270227,30799288,2005.csv,2005,72.3%,27.7%
920,Mission to Mars,110983407,60883407,50100000,2000.csv,2000,54.9%,45.1%
921,Good Boys,110940306,83140306,27800000,2019.csv,2019,74.9%,25.1%
922,Free Birds,110387072,55750480,54636592,2013.csv,2013,50.5%,49.5%
923,The Kid,110317580,69691949,40625631,2000.csv,2000,63.2%,36.8%
924,10 Cloverfield Lane,110216998,72082998,38134000,2016.csv,2016,65.4%,34.6%
925,Moneyball,110206216,75605492,34600724,2011.csv,2011,68.6%,31.4%
926,Buddies in India,110155128,293194,109861934,2017.csv,2017,0.3%,99.7%
927,Hoodwinked!,110013167,51386611,58626556,2005.csv,2005,46.7%,53.3%
928,The 5th Wave,109906372,34916787,74989585,2015.csv,2015,31.8%,68.2%
929,Peter Pan 2: Return to Never Land,109862682,48430258,61432424,2002.csv,2002,44.1%,55.9%
930,Sideways,109706931,71503593,38203338,2004.csv,2004,65.2%,34.8%
931,Treasure Planet,109578115,38176783,71401332,2002.csv,2002,34.8%,65.2%
932,Along With the Gods: The Two Worlds,109383972,1908823,107475149,2017.csv,2017,1.7%,98.3%
933,Billy Elliot,109280263,21995263,87285000,2000.csv,2000,20.1%,79.9%
934,The Hours,108846072,41675994,67170078,2002.csv,2002,38.3%,61.7%
935,Sanctum,108609310,23209310,85400000,2010.csv,2010,21.4%,78.6%
936,Cinderella Man,108539911,61649911,46890000,2005.csv,2005,56.8%,43.2%
937,The Boxtrolls,108255770,50837305,57418465,2014.csv,2014,47%,53%
938,Hidalgo,108040622,67303450,40737172,2004.csv,2004,62.3%,37.7%
939,Neighbors 2: Sorority Rising,108007109,55455765,52551344,2016.csv,2016,51.3%,48.7%
940,Horrible Bosses 2,107645357,54445357,53200000,2014.csv,2014,50.6%,49.4%
941,The Call of the Wild,107604626,62342368,45262258,2020.csv,2020,57.9%,42.1%
942,Paul Blart: Mall Cop 2,107588225,71038190,36550035,2015.csv,2015,66%,34%
943,The Amityville Horror,107516369,65233369,42283000,2005.csv,2005,60.7%,39.3%
944,Vacation,107228221,58884188,48344033,2015.csv,2015,54.9%,45.1%
945,Shaft,107196498,70334258,36862240,2000.csv,2000,65.6%,34.4%
946,ParaNorman,107139399,56003051,51136348,2012.csv,2012,52.3%,47.7%
947,The Texas Chainsaw Massacre,107071655,80571655,26500000,2003.csv,2003,75.3%,24.7%
948,The Man from U.N.C.L.E.,107045109,45445109,61600000,2015.csv,2015,42.5%,57.5%
949,The Breakup Guru,106980263,208959,106771304,2014.csv,2014,0.2%,99.8%
950,Hereafter,106956330,32746941,74209389,2010.csv,2010,30.6%,69.4%
951,The Whole Nine Yards,106371651,57262492,49109159,2000.csv,2000,53.8%,46.2%
952,Shaun the Sheep Movie,106209378,19375982,86833396,2015.csv,2015,18.2%,81.8%
953,About Schmidt,105834556,65016287,40818269,2002.csv,2002,61.4%,38.6%
954,Life as We Know It,105734416,53374681,52359735,2010.csv,2010,50.5%,49.5%
955,First Man,105697415,44936545,60760870,2018.csv,2018,42.5%,57.5%
956,Scary Stories to Tell in the Dark,105647580,68947075,36700505,2019.csv,2019,65.3%,34.7%
957,The Brothers Grimm,105316267,37916267,67400000,2005.csv,2005,36%,64%
958,Gangster Squad,105200903,46000903,59200000,2013.csv,2013,43.7%,56.3%
959,Along Came a Spider,105178561,74078174,31100387,2001.csv,2001,70.4%,29.6%
960,Sisters,105011053,87044645,17966408,2015.csv,2015,82.9%,17.1%
961,The Campaign,104907746,86907746,18000000,2012.csv,2012,82.8%,17.2%
962,Training Day,104876233,76631907,28244326,2001.csv,2001,73.1%,26.9%
963,Let the Bullets Fly,104723314,63012,104660302,2010.csv,2010,<0.1%,99.9%
964,The Hitchhiker's Guide to the Galaxy,104478416,51085416,53393000,2005.csv,2005,48.9%,51.1%
965,Book Club,104438188,68566296,35871892,2018.csv,2018,65.7%,34.3%
966,The Tuxedo,104391623,50547998,53843625,2002.csv,2002,48.4%,51.6%
967,The Cell,104155843,61334059,42821784,2000.csv,2000,58.9%,41.1%
968,Ouija,103590271,50856010,52734261,2014.csv,2014,49.1%,50.9%
969,The Stepford Wives,103370127,59484742,43885385,2004.csv,2004,57.5%,42.5%
970,Rugrats in Paris: The Movie,103291131,76507756,26783375,2000.csv,2000,74.1%,25.9%
971,Birdman or (The Unexpected Virtue of Ignorance),103215094,42340598,60874496,2014.csv,2014,41%,59%
972,Cold War II,103197501,560824,102636677,2016.csv,2016,0.5%,99.5%
973,Guess Who,103121466,68915888,34205578,2005.csv,2005,66.8%,33.2%
974,Night School,103105878,77339130,25766748,2018.csv,2018,75%,25%
975,Saw,103096345,55185045,47911300,2004.csv,2004,53.5%,46.5%
976,Transcendence,103039258,23022309,80016949,2014.csv,2014,22.3%,77.7%
977,Jimmy Neutron: Boy Genius,102992536,80936232,22056304,2001.csv,2001,78.6%,21.4%
978,Resident Evil,102984862,40119709,62865153,2002.csv,2002,39%,61%
979,Jigsaw,102952888,38052832,64900056,2017.csv,2017,37%,63%
980,Just Like Heaven,102854431,48318130,54536301,2005.csv,2005,47%,53%
981,Love & Other Drugs,102820008,32367005,70453003,2010.csv,2010,31.5%,68.5%
982,Chappie,102811889,31569268,71242621,2015.csv,2015,30.7%,69.3%
983,Star Wars: Episode I - The Phantom Menace 2012 3D Release,102739593,43456382,59283211,2012.csv,2012,42.3%,57.7%
984,Project X,102731865,54731865,48000000,2012.csv,2012,53.3%,46.7%
985,Dawn of the Dead,102278712,59020957,43257755,2004.csv,2004,57.7%,42.3%
986,John Q,102244770,71756802,30487968,2002.csv,2002,70.2%,29.8%
987,Railroad Tigers,102205175,218044,101987131,2016.csv,2016,0.2%,99.8%
988,Heaven Is for Real,101888019,91443253,10444766,2014.csv,2014,89.7%,10.3%
989,The Devil Inside,101758490,53261944,48496546,2012.csv,2012,52.3%,47.7%
990,Just Married,101564935,56127162,45437773,2003.csv,2003,55.3%,44.7%
991,Miss Congeniality 2: Armed & Fabulous,101393569,48478006,52915563,2005.csv,2005,47.8%,52.2%
992,The Recruit,101191884,52802140,48389744,2003.csv,2003,52.2%,47.8%
993,Joy,101134059,56451232,44682827,2015.csv,2015,55.8%,44.2%
994,Kung Fu Hustle,100912445,17108591,83803854,2004.csv,2004,17%,83%
995,"Alexander and the Terrible, Horrible, No Good, Very Bad Day",100654149,66954149,33700000,2014.csv,2014,66.5%,33.5%
996,Ladder 49,100572044,74541707,26030337,2004.csv,2004,74.1%,25.9%
997,Life,100541806,30234022,70307784,2017.csv,2017,30.1%,69.9%
998,Instructions Not Included,100486616,44467206,56019410,2013.csv,2013,44.3%,55.7%
999,Tammy,100375432,84525432,15850000,2014.csv,2014,84.2%,15.8%
1000,PK,100370104,10616104,89754000,2014.csv,2014,10.6%,89.4%
1001,Aftershock,100293273,62962,100230311,2010.csv,2010,<0.1%,99.9%
1002,Philomena,100129872,37709979,62419893,2013.csv,2013,37.7%,62.3%
1003,Don't Say a Word,100020092,55001642,45018450,2001.csv,2001,55%,45%
1004,Atomic Blonde,100014025,51687870,48326155,2017.csv,2017,51.7%,48.3%
1005,The Book of Life,99783556,50151543,49632013,2014.csv,2014,50.3%,49.7%
1006,Black Mass,99775678,62575678,37200000,2015.csv,2015,62.7%,37.3%
1007,Insidious,99557032,54009150,45547882,2011.csv,2011,54.2%,45.8%
1008,Line Walker 2: Invisible Spy,99482027,296751,99185276,2019.csv,2019,0.3%,99.7%
1009,The Lucky One,99357138,60457138,38900000,2012.csv,2012,60.8%,39.2%
1010,Hellboy,99318987,59623958,39695029,2004.csv,2004,60%,40%
1011,Shanghai Noon,99274467,56937502,42336965,2000.csv,2000,57.4%,42.6%
1012,Blue Jasmine,99104804,33405481,65699323,2013.csv,2013,33.7%,66.3%
1013,Ode to My Father,99085291,2300121,96785170,2014.csv,2014,2.3%,97.7%
1014,Justin Bieber: Never Say Never,99036827,73013910,26022917,2011.csv,2011,73.7%,26.3%
1015,Young Detective Dee: Rise of the Sea Dragon,98774891,87783,98687108,2013.csv,2013,<0.1%,99.9%
1016,Spotlight,98690254,45055776,53634478,2015.csv,2015,45.7%,54.3%
1017,Devil and Angel,98599942,131058,98468884,2015.csv,2015,0.1%,99.9%
1018,The Visit,98450062,65206105,33243957,2015.csv,2015,66.2%,33.8%
1019,Crash,98410061,54580300,43829761,2005.csv,2005,55.5%,44.5%
1020,Evolution,98376292,38345494,60030798,2001.csv,2001,39%,61%
1021,Riddick,98337295,42025135,56312160,2013.csv,2013,42.7%,57.3%
1022,Alpha,98203196,35857181,62346015,2018.csv,2018,36.5%,63.5%
1023,Killers,98159963,47059963,51100000,2010.csv,2010,47.9%,52.1%
1024,Once Upon a Time in Mexico,98096026,56359780,41736246,2003.csv,2003,57.5%,42.5%
1025,Paul,97984015,37412945,60571070,2011.csv,2011,38.2%,61.8%
1026,Along With the Gods: The Last 49 Days,97962238,1200246,96761992,2018.csv,2018,1.2%,98.8%
1027,Are We There Yet?,97918663,82674398,15244265,2005.csv,2005,84.4%,15.6%
1028,Phone Booth,97837138,46566212,51270926,2003.csv,2003,47.6%,52.4%
1029,I Am Sam,97818139,40311852,57506287,2001.csv,2001,41.2%,58.8%
1030,A Simple Favor,97644617,53548586,44096031,2018.csv,2018,54.8%,45.2%
1031,Safe Haven,97594140,71349120,26245020,2013.csv,2013,73.1%,26.9%
1032,The Little Prince,97571250,1339152,96232098,2015.csv,2015,1.4%,98.6%
1033,Evil Dead,97542952,54239856,43303096,2013.csv,2013,55.6%,44.4%
1034,42,97470701,95020213,2450488,2013.csv,2013,97.5%,2.5%
1035,Scream 4,97138686,38180928,58957758,2011.csv,2011,39.3%,60.7%
1036,Jarhead,97076152,62658220,34417932,2005.csv,2005,64.5%,35.5%
1037,Enemy at the Gates,96976270,51401758,45574512,2001.csv,2001,53%,47%
1038,The Shack,96942115,57386418,39555697,2017.csv,2017,59.2%,40.8%
1039,The Butterfly Effect,96822421,57938693,38883728,2004.csv,2004,59.8%,40.2%
1040,Christmas with the Kranks,96572480,73780539,22791941,2004.csv,2004,76.4%,23.6%
1041,The Rite,96560591,33047633,63512958,2011.csv,2011,34.2%,65.8%
1042,13 Going on 30,96455697,57231747,39223950,2004.csv,2004,59.3%,40.7%
1043,Contraband,96262212,66528000,29734212,2012.csv,2012,69.1%,30.9%
1044,Red Eye,96258201,57891803,38366398,2005.csv,2005,60.1%,39.9%
1045,Kick-Ass,96188903,48071303,48117600,2010.csv,2010,50%,50%
1046,The Tigger Movie,96159800,45554533,50605267,2000.csv,2000,47.4%,52.6%
1047,Amsal,96119773,1904682,94215091,2015.csv,2015,2%,98%
1048,The Manchurian Candidate,96105910,65955630,30150280,2004.csv,2004,68.6%,31.4%
1049,The 6th Day,96085477,34604280,61481197,2000.csv,2000,36%,64%
1050,Think Like a Man,96070507,91547205,4523302,2012.csv,2012,95.3%,4.7%
1051,Dolphin Tale,95932565,72286779,23645786,2011.csv,2011,75.4%,24.6%
1052,The Favourite,95918706,34366783,61551923,2018.csv,2018,35.8%,64.2%
1053,Be Cool,95763716,56046979,39716737,2005.csv,2005,58.5%,41.5%
1054,Some Like It Hot,95721320,100026,95621294,2016.csv,2016,0.1%,99.9%
1055,Underworld,95708457,51970690,43737767,2003.csv,2003,54.3%,45.7%
1056,Poltergeist,95437994,47425125,48012869,2015.csv,2015,49.7%,50.3%
1057,The Mortal Instruments: City of Bones,95396573,31165421,64231152,2013.csv,2013,32.7%,67.3%
1058,Blumhouse's Truth or Dare,95330493,41411015,53919478,2018.csv,2018,43.4%,56.6%
1059,Rush,95224595,26947624,68276971,2013.csv,2013,28.3%,71.7%
1060,40 Days and 40 Nights,95146283,37950822,57195461,2002.csv,2002,39.9%,60.1%
1061,The Hustle,95017038,35417038,59600000,2019.csv,2019,37.3%,62.7%
1062,Changing Lanes,94935764,66818548,28117216,2002.csv,2002,70.4%,29.6%
1063,The Wedding Planner,94728529,60400856,34327673,2001.csv,2001,63.8%,36.2%
1064,I Feel Pretty,94539426,48795601,45743825,2018.csv,2018,51.6%,48.4%
1065,Veteran,94393020,1200627,93192393,2015.csv,2015,1.3%,98.7%
1066,Masquerade,94268432,922921,93345511,2012.csv,2012,1%,99%
1067,Police Story: Lockdown,94249025,0,94249025,2013.csv,2013,-,100%
1068,Cong cong na nian,94244191,569280,93674911,2014.csv,2014,0.6%,99.4%
1069,Dirty Grandpa,94073028,35593113,58479915,2016.csv,2016,37.8%,62.2%
1070,Ben-Hur,94061311,26410477,67650834,2016.csv,2016,28.1%,71.9%
1071,Blockers,94017294,60311495,33705799,2018.csv,2018,64.1%,35.9%
1072,The Skeleton Key,93983911,47907715,46076196,2005.csv,2005,51%,49%
1073,Syriana,93974620,50824620,43150000,2005.csv,2005,54.1%,45.9%
1074,In the Heart of the Sea,93920758,25020758,68900000,2015.csv,2015,26.6%,73.4%
1075,Nothing to Declare,93811164,0,93811164,2011.csv,2011,-,100%
1076,Kill Zone 2,93638358,11998,93626360,2015.csv,2015,<0.1%,100%
1077,The Internship,93492844,44672764,48820080,2013.csv,2013,47.8%,52.2%
1078,BlacKkKlansman,93400823,49275340,44125483,2018.csv,2018,52.8%,47.2%
1079,Calendar Girls,93400759,31041759,62359000,2003.csv,2003,33.2%,66.8%
1080,Goosebumps 2: Haunted Halloween,93320380,46700633,46619747,2018.csv,2018,50%,50%
1081,Money Monster,93282604,41012075,52270529,2016.csv,2016,44%,56%
1082,Nanny McPhee Returns,93251121,29011215,64239906,2010.csv,2010,31.1%,68.9%
1083,Secret Window,92913171,48022900,44890271,2004.csv,2004,51.7%,48.3%
1084,The Family Stone,92884429,60062868,32821561,2005.csv,2005,64.7%,35.3%
1085,House of Flying Daggers,92863945,11050094,81813851,2004.csv,2004,11.9%,88.1%
1086,Train to Busan,92688375,2129768,90558607,2016.csv,2016,2.3%,97.7%
1087,Four Brothers,92374674,74494381,17880293,2005.csv,2005,80.6%,19.4%
1088,Downfall,92181574,5509040,86672534,2004.csv,2004,6%,94%
1089,Southpaw,91970827,52421953,39548874,2015.csv,2015,57%,43%
1090,Behind Enemy Lines,91753202,58856790,32896412,2001.csv,2001,64.1%,35.9%
1091,Get Him to the Greek,91720255,60974475,30745780,2010.csv,2010,66.5%,33.5%
1092,Shadow,91708374,521396,91186978,2018.csv,2018,0.6%,99.4%
1093,Season of the Witch,91627228,24827228,66800000,2011.csv,2011,27.1%,72.9%
1094,Crawl,91542097,39014193,52527904,2019.csv,2019,42.6%,57.4%
1095,Five Feet Apart,91522094,45729221,45792873,2019.csv,2019,50%,50%
1096,Rambo: Last Blood,91490353,44819352,46671001,2019.csv,2019,49%,51%
1097,Overboard,91244913,50316123,40928790,2018.csv,2018,55.1%,44.9%
1098,White Noise,91196419,56386759,34809660,2005.csv,2005,61.8%,38.2%
1099,Romeo Must Die,91036760,55973336,35063424,2000.csv,2000,61.5%,38.5%
1100,Final Destination 2,90941129,46961214,43979915,2003.csv,2003,51.6%,48.4%
1101,Paranormal Activity: The Marked Ones,90894962,32462372,58432590,2014.csv,2014,35.7%,64.3%
1102,Fantasia 2000,90874570,60655420,30219150,2000.csv,2000,66.7%,33.3%
1103,Racing Stripes,90754475,49772522,40981953,2005.csv,2005,54.8%,45.2%
1104,Autumn in New York,90726668,37761915,52964753,2000.csv,2000,41.6%,58.4%
1105,Anchorman: The Legend of Ron Burgundy,90649730,85288303,5361427,2004.csv,2004,94.1%,5.9%
1106,My Big Fat Greek Wedding 2,90632641,59689605,30943036,2016.csv,2016,65.9%,34.1%
1107,Sherlock Gnomes,90497778,43242871,47254907,2018.csv,2018,47.8%,52.2%
1108,Bring It On,90449929,68379000,22070929,2000.csv,2000,75.6%,24.4%
1109,Bedazzled,90383208,37886980,52496228,2000.csv,2000,41.9%,58.1%
1110,Jojo Rabbit,90335025,33370906,56964119,2019.csv,2019,36.9%,63.1%
1111,Red Riding Hood,90260376,37662162,52598214,2011.csv,2011,41.7%,58.3%
1112,Identity,90259536,52159536,38100000,2003.csv,2003,57.8%,42.2%
1113,Detective Dee: The Four Heavenly Kings,90040771,262963,89777808,2018.csv,2018,0.3%,99.7%
1114,Sucker Punch,89792502,36392502,53400000,2011.csv,2011,40.5%,59.5%
1115,Burlesque,89519773,39440655,50079118,2010.csv,2010,44.1%,55.9%
1116,The Hundred-Foot Journey,89514453,54240821,35273632,2014.csv,2014,60.6%,39.4%
1117,The Purge,89328627,64473115,24855512,2013.csv,2013,72.2%,27.8%
1118,The Last Song,89137047,62950384,26186663,2010.csv,2010,70.6%,29.4%
1119,Transporter 2,89083229,43095856,45987373,2005.csv,2005,48.4%,51.6%
1120,Rumor Has It...,88933562,43000262,45933300,2005.csv,2005,48.4%,51.6%
1121,Kangaroo Jack,88929111,66934963,21994148,2003.csv,2003,75.3%,24.7%
1122,The Inbetweeners Movie,88823111,36000,88787111,2011.csv,2011,<0.1%,100%
1123,Collateral Beauty,88528280,31016021,57512259,2016.csv,2016,35%,65%
1124,Shanghai Knights,88323487,60476872,27846615,2003.csv,2003,68.5%,31.5%
1125,This Is 40,88215156,67544505,20670651,2012.csv,2012,76.6%,23.4%
1126,Dhoom 3,88031955,8031955,80000000,2013.csv,2013,9.1%,90.9%
1127,Chasing the Dragon,87965942,456854,87509088,2017.csv,2017,0.5%,99.5%
1128,Deliver Us from Evil,87937815,30577122,57360693,2014.csv,2014,34.8%,65.2%
1129,Gosford Park,87754044,41308615,46445429,2001.csv,2001,47.1%,52.9%
1130,Ali,87713825,58203105,29510720,2001.csv,2001,66.4%,33.6%
1131,Tiger Zinda Hai,87320000,5560921,81759079,2017.csv,2017,6.4%,93.6%
1132,Pain & Gain,87305549,49875291,37430258,2013.csv,2013,57.1%,42.9%
1133,Sultan,87280000,6200000,81080000,2016.csv,2016,7.1%,92.9%
1134,A Million Ways to Die in the West,87189756,43139300,44050456,2014.csv,2014,49.5%,50.5%
1135,Old School,87135520,75585093,11550427,2003.csv,2003,86.7%,13.3%
1136,The Thieves,87126367,685839,86440528,2012.csv,2012,0.8%,99.2%
1137,About Time,87100449,15322921,71777528,2013.csv,2013,17.6%,82.4%
1138,Dinner for Schmucks,86855739,73026337,13829402,2010.csv,2010,84.1%,15.9%
1139,Snowpiercer,86758912,4563650,82195262,2013.csv,2013,5.3%,94.7%
1140,The Lincoln Lawyer,86752352,58009200,28743152,2011.csv,2011,66.9%,33.1%
1141,Robin Hood,86489031,30824628,55664403,2018.csv,2018,35.6%,64.4%
1142,Tears of the Sun,86468162,43734876,42733286,2003.csv,2003,50.6%,49.4%
1143,Sky High,86369815,63946815,22423000,2005.csv,2005,74%,26%
1144,A Taxi Driver,86252940,1527829,84725111,2017.csv,2017,1.8%,98.2%
1145,War Dogs,86234523,43034523,43200000,2016.csv,2016,49.9%,50.1%
1146,Step Up All In,86165646,14904384,71261262,2014.csv,2014,17.3%,82.7%
1147,Hall Pass,86157237,45060734,41096503,2011.csv,2011,52.3%,47.7%
1148,I Can Only Imagine,86026201,83482352,2543849,2018.csv,2018,97%,3%
1149,John Wick,86013056,43037835,42975221,2014.csv,2014,50%,50%
1150,The Second Best Exotic Marigold Hotel,85978266,33078266,52900000,2015.csv,2015,38.5%,61.5%
1151,Match Point,85638656,23151529,62487127,2005.csv,2005,27%,73%
1152,Spy Kids 4-D: All the Time in the World,85564310,38538188,47026122,2011.csv,2011,45%,55%
1153,Paper Towns,85512300,32000304,53511996,2015.csv,2015,37.4%,62.6%
1154,Rat Race,85498534,56618055,28880479,2001.csv,2001,66.2%,33.8%
1155,The Possession,85446075,49130154,36315921,2012.csv,2012,57.5%,42.5%
1156,Nerve,85251425,38583626,46667799,2016.csv,2016,45.3%,54.7%
1157,Final Fantasy: The Spirits Within,85131830,32131830,53000000,2001.csv,2001,37.7%,62.3%
1158,J. Edgar,84920539,37306030,47614509,2011.csv,2011,43.9%,56.1%
1159,Going in Style,84918541,45018541,39900000,2017.csv,2017,53%,47%
1160,Sicario,84872444,46889293,37983151,2015.csv,2015,55.2%,44.8%
1161,Carrie,84790678,35266619,49524059,2013.csv,2013,41.6%,58.4%
1162,The Animal,84772742,57743062,27029680,2001.csv,2001,68.1%,31.9%
1163,The Judge,84419388,47119388,37300000,2014.csv,2014,55.8%,44.2%
1164,What to Expect When You're Expecting,84384002,41152203,43231799,2012.csv,2012,48.8%,51.2%
1165,Leap!,84197417,2844490,81352927,2016.csv,2016,3.4%,96.6%
1166,Finding Mr. Right,84112033,6945,84105088,2013.csv,2013,<0.1%,100%
1167,Marmaduke,83761844,33644788,50117056,2010.csv,2010,40.2%,59.8%
1168,In Her Shoes,83697473,32880591,50816882,2005.csv,2005,39.3%,60.7%
1169,Mortal Engines,83672673,15951040,67721633,2018.csv,2018,19.1%,80.9%
1170,Snatch,83557872,30328156,53229716,2000.csv,2000,36.3%,63.7%
1171,Blow,83282296,52990775,30291521,2001.csv,2001,63.6%,36.4%
1172,Piranha 3D,83188165,25003155,58185010,2010.csv,2010,30.1%,69.9%
1173,Rings,83080890,27793018,55287872,2017.csv,2017,33.5%,66.5%
1174,Savages,82966152,47382068,35584084,2012.csv,2012,57.1%,42.9%
1175,Once Upon A Time,82886178,485728,82400450,2017.csv,2017,0.6%,99.4%
1176,28 Days Later...,82719885,45064915,37654970,2002.csv,2002,54.5%,45.5%
1177,"Big Mommas: Like Father, Like Son",82686066,37915414,44770652,2011.csv,2011,45.9%,54.1%
1178,Oceans 2010 Re-release,82651439,19422319,63229120,2010.csv,2010,23.5%,76.5%
1179,Sinister,82515113,48086903,34428210,2012.csv,2012,58.3%,41.7%
1180,Act of Valor,82497035,70012847,12484188,2012.csv,2012,84.9%,15.1%
1181,The Constant Gardener,82466670,33579797,48886873,2005.csv,2005,40.7%,59.3%
1182,Hitman: Agent 47,82347656,22467450,59880206,2015.csv,2015,27.3%,72.7%
1183,Men of Honor,82343495,48818921,33524574,2000.csv,2000,59.3%,40.7%
1184,Reign of Fire,82150183,43061982,39088201,2002.csv,2002,52.4%,47.6%
1185,Catwoman,82102379,40202379,41900000,2004.csv,2004,49%,51%
1186,Abduction,82087155,28087155,54000000,2011.csv,2011,34.2%,65.8%
1187,The Chorus,82032134,2087128,79945006,2004.csv,2004,2.5%,97.5%
1188,Ouija: Origin of Evil,81705746,35144505,46561241,2016.csv,2016,43%,57%
1189,One Piece: Stampede,81562741,1298528,80264213,2019.csv,2019,1.6%,98.4%
1190,Frankenweenie,81491068,35291068,46200000,2012.csv,2012,43.3%,56.7%
1191,Tinker Tailor Soldier Spy,81244605,24149393,57095212,2011.csv,2011,29.7%,70.3%
1192,Edge of Darkness,81126522,43313890,37812632,2010.csv,2010,53.4%,46.6%
1193,Underworld: Blood Wars,81093313,30353973,50739340,2016.csv,2016,37.4%,62.6%
1194,Sinbad: Legend of the Seven Seas,80773077,26483452,54289625,2003.csv,2003,32.8%,67.2%
1195,A Dog's Way Home,80708134,42004346,38703788,2019.csv,2019,52%,48%
1196,The Rookie,80693537,75600072,5093465,2002.csv,2002,93.7%,6.3%
1197,The Rundown,80657921,47726342,32931579,2003.csv,2003,59.2%,40.8%
1198,Go Away Mr Tumour,80606893,286639,80320254,2015.csv,2015,0.4%,99.6%
1199,Vampires Suck,80547866,36661504,43886362,2010.csv,2010,45.5%,54.5%
1200,Den of Thieves,80509622,44947622,35562000,2018.csv,2018,55.8%,44.2%
1201,Muppets Most Wanted,80383113,51183113,29200000,2014.csv,2014,63.7%,36.3%
1202,Hereditary,80239658,44069456,36170202,2018.csv,2018,54.9%,45.1%
1203,Runaway Jury,80154140,49443628,30710512,2003.csv,2003,61.7%,38.3%
1204,Finding Forrester,80049764,51804714,28245050,2000.csv,2000,64.7%,35.3%
1205,Exit Wounds,79958599,51758599,28200000,2001.csv,2001,64.7%,35.3%
1206,The Wedding Ringer,79799880,64460211,15339669,2015.csv,2015,80.8%,19.2%
1207,The Grey,79781695,51580236,28201459,2012.csv,2012,64.7%,35.3%
1208,Letters to Juliet,79628830,53032453,26596377,2010.csv,2010,66.6%,33.4%
1209,Jackass: The Movie,79493831,64255312,15238519,2002.csv,2002,80.8%,19.2%
1210,Good Bye Lenin!,79316957,4064200,75252757,2003.csv,2003,5.1%,94.9%
1211,Stealth,79268322,32116746,47151576,2005.csv,2005,40.5%,59.5%
1212,Manchester by the Sea,78988148,47695371,31292777,2016.csv,2016,60.4%,39.6%
1213,Lady Bird,78965611,48958273,30007338,2017.csv,2017,62%,38%
1214,Paranormal Activity: The Ghost Dimension,78903124,18300124,60603000,2015.csv,2015,23.2%,76.8%
1215,The Boss,78844582,63285885,15558697,2016.csv,2016,80.3%,19.7%
1216,The Attorney,78547586,557236,77990350,2013.csv,2013,0.7%,99.3%
1217,The Family,78418811,36918811,41500000,2013.csv,2013,47.1%,52.9%
1218,Collateral Damage,78382433,40077257,38305176,2002.csv,2002,51.1%,48.9%
1219,Scary Movie 5,78378744,32015787,46362957,2013.csv,2013,40.8%,59.2%
1220,R.I.P.D.,78324220,33618855,44705365,2013.csv,2013,42.9%,57.1%
1221,Priest,78309505,29137000,49172505,2011.csv,2011,37.2%,62.8%
1222,If I Stay,78274843,50474843,27800000,2014.csv,2014,64.5%,35.5%
1223,Tag,78130625,54730625,23400000,2018.csv,2018,70.1%,29.9%
1224,Exorcist: The Beginning,78110021,41821986,36288035,2004.csv,2004,53.5%,46.5%
1225,Shin Godzilla,77947607,1918403,76029204,2016.csv,2016,2.5%,97.5%
1226,Showtime,77741732,38082712,39659020,2002.csv,2002,49%,51%
1227,Tiny Times,77717014,23462,77693552,2013.csv,2013,<0.1%,100%
1228,Windtalkers,77628265,40914068,36714197,2002.csv,2002,52.7%,47.3%
1229,Hostage,77608617,34639939,42968678,2005.csv,2005,44.6%,55.4%
1230,Serendipity,77516304,50294317,27221987,2001.csv,2001,64.9%,35.1%
1231,The Back-up Plan,77477008,37490007,39987001,2010.csv,2010,48.4%,51.6%
1232,Diary of a Wimpy Kid: Dog Days,77229695,49008662,28221033,2012.csv,2012,63.5%,36.5%
1233,Mike and Dave Need Wedding Dates,77068246,46009673,31058573,2016.csv,2016,59.7%,40.3%
1234,Barbershop,77063924,75782105,1281819,2002.csv,2002,98.3%,1.7%
1235,Drive,76976666,35061555,41915111,2011.csv,2011,45.5%,54.5%
1236,"I, Frankenstein",76801179,19075290,57725889,2014.csv,2014,24.8%,75.2%
1237,Sanju,76693052,7909317,68783735,2018.csv,2018,10.3%,89.7%
1238,Coach Carter,76669554,67264877,9404677,2005.csv,2005,87.7%,12.3%
1239,The Ladykillers,76665191,39799191,36866000,2004.csv,2004,51.9%,48.1%
1240,The Book Thief,76586316,21488481,55097835,2013.csv,2013,28.1%,71.9%
1241,Bend It Like Beckham,76583333,32543449,44039884,2002.csv,2002,42.5%,57.5%
1242,Bad Santa,76488889,60060328,16428561,2003.csv,2003,78.5%,21.5%
1243,The Road to El Dorado,76432727,50863742,25568985,2000.csv,2000,66.5%,33.5%
1244,Cold Pursuit,76419755,32138862,44280893,2019.csv,2019,42.1%,57.9%
1245,The Ides of March,76338111,40962534,35375577,2011.csv,2011,53.7%,46.3%
1246,Kubo and the Two Strings,76249438,48023088,28226350,2016.csv,2016,63%,37%
1247,Diary of a Wimpy Kid,76196538,64003625,12192913,2010.csv,2010,84%,16%
1248,Tae Guk Gi: The Brotherhood of War,76194339,1111061,75083278,2004.csv,2004,1.5%,98.5%
1249,The Mechanic,76130093,29121498,47008595,2011.csv,2011,38.3%,61.7%
1250,If You Are the One 2,76085443,426894,75658549,2010.csv,2010,0.6%,99.4%
1251,Vice,76073488,47836282,28237206,2018.csv,2018,62.9%,37.1%
1252,Kate & Leopold,76019048,47121859,28897189,2001.csv,2001,62%,38%
1253,Widows,75984700,42402632,33582068,2018.csv,2018,55.8%,44.2%
1254,Sicario: Day of the Soldado,75837743,50072235,25765508,2018.csv,2018,66%,34%
1255,Dreamcatcher,75715436,33715436,42000000,2003.csv,2003,44.5%,55.5%
1256,A Dog's Journey,75602573,22782371,52820202,2019.csv,2019,30.1%,69.9%
1257,Bajrangi Bhaijaan,75547184,8178001,67369183,2015.csv,2015,10.8%,89.2%
1258,Manitou's Shoe,75482094,0,75482094,2001.csv,2001,-,100%
1259,Searching,75462037,26020957,49441080,2018.csv,2018,34.5%,65.5%
1260,The Change-Up,75450437,37081475,38368962,2011.csv,2011,49.1%,50.9%
1261,The Count of Monte Cristo,75395048,54234062,21160986,2002.csv,2002,71.9%,28.1%
1262,The Spy Who Dumped Me,75320680,33562069,41758611,2018.csv,2018,44.6%,55.4%
1263,Larry Crowne,75055070,35608245,39446825,2011.csv,2011,47.4%,52.6%
1264,Easy A,75026216,58401464,16624752,2010.csv,2010,77.8%,22.2%
1265,Tyler Perry's Boo! A Madea Halloween,74827344,73206343,1621001,2016.csv,2016,97.8%,2.2%
1266,A Madea Family Funeral,74747725,73257045,1490680,2019.csv,2019,98%,2%
1267,Crimson Peak,74679822,31090320,43589502,2014.csv,2014,41.6%,58.4%
1268,Escape from Planet Earth,74597643,57012977,17584666,2013.csv,2013,76.4%,23.6%
1269,From Hell,74558115,31602566,42955549,2001.csv,2001,42.4%,57.6%
1270,Hubble 3D,74249729,52522904,21726825,2010.csv,2010,70.7%,29.3%
1271,August: Osage County,74188937,37738810,36450127,2013.csv,2013,50.9%,49.1%
1272,Eternal Sunshine of the Spotless Mind,74036715,34400301,39636414,2004.csv,2004,46.5%,53.5%
1273,Miracles from Heaven,73983003,61705123,12277880,2016.csv,2016,83.4%,16.6%
1274,Divine Secrets of the Ya-Ya Sisterhood,73839240,69599016,4240224,2002.csv,2002,94.3%,5.7%
1275,Cats,73695985,27166770,46529215,2019.csv,2019,36.9%,63.1%
1276,The Core,73498611,31186896,42311715,2003.csv,2003,42.4%,57.6%
1277,Charlie's Angels,73279888,17803077,55476811,2019.csv,2019,24.3%,75.7%
1278,War Room,73256266,67790117,5466149,2015.csv,2015,92.5%,7.5%
1279,To Rome with Love,73244881,16685867,56559014,2012.csv,2012,22.8%,77.2%
1280,"Dude, Where's My Car?",73180723,46729800,26450923,2000.csv,2000,63.9%,36.1%
1281,Here Comes the Boom,73100172,45290318,27809854,2012.csv,2012,62%,38%
1282,Without a Paddle,73029190,58169327,14859863,2004.csv,2004,79.7%,20.3%
1283,The Best Man Holiday,72835710,70525195,2310515,2013.csv,2013,96.8%,3.2%
1284,The One,72689126,43905746,28783380,2001.csv,2001,60.4%,39.6%
1285,"Yours, Mine & Ours",72662923,53412862,19250061,2005.csv,2005,73.5%,26.5%
1286,The Transporter Refuelled,72629670,16029670,56600000,2015.csv,2015,22.1%,77.9%
1287,Lord of War,72617068,24149632,48467436,2005.csv,2005,33.3%,66.7%
1288,Diary of a Wimpy Kid: Rodrick Rules,72526996,52698535,19828461,2011.csv,2011,72.7%,27.3%
1289,Doctor Sleep,72381712,31581712,40800000,2019.csv,2019,43.6%,56.4%
1290,Second Act,72282227,39282227,33000000,2018.csv,2018,54.3%,45.7%
1291,What Men Want,72216294,54611903,17604391,2019.csv,2019,75.6%,24.4%
1292,Around the World in 80 Days,72178895,24008137,48170758,2004.csv,2004,33.3%,66.7%
1293,The Adventures of Sharkboy and Lavagirl 3-D,71992655,39177684,32814971,2005.csv,2005,54.4%,45.6%
1294,"O Brother, Where Art Thou?",71868327,45512588,26355739,2000.csv,2000,63.3%,36.7%
1295,Rules of Engagement,71732303,61335230,10397073,2000.csv,2000,85.5%,14.5%
1296,Run All Night,71561644,26461644,45100000,2015.csv,2015,37%,63%
1297,The Royal Tenenbaums,71441250,52364010,19077240,2001.csv,2001,73.3%,26.7%
1298,Brick Mansions,71416730,20396829,51019901,2014.csv,2014,28.6%,71.4%
1299,Holes,71406573,67406573,4000000,2003.csv,2003,94.4%,5.6%
1300,Down to Earth,71186502,64186502,7000000,2001.csv,2001,90.2%,9.8%
1301,xXx: State of the Union,71022693,26873932,44148761,2005.csv,2005,37.8%,62.2%
1302,The Counselor,71009334,16973715,54035619,2013.csv,2013,23.9%,76.1%
1303,Anacondas: The Hunt for the Blood Orchid,70992898,32238923,38753975,2004.csv,2004,45.4%,54.6%
1304,Son of God,70829270,59700064,11129206,2014.csv,2014,84.3%,15.7%
1305,I Am Not Madame Bovary,70826207,436798,70389409,2016.csv,2016,0.6%,99.4%
1306,Taxi 2004 Re-release,70778329,36611066,34167263,2004.csv,2004,51.7%,48.3%
1307,Brotherhood of the Wolf,70752904,11260096,59492808,2001.csv,2001,15.9%,84.1%
1308,Spirited Away 2018 Re-release,70186029,1175067,69010962,2018.csv,2018,1.7%,98.3%
1309,Think Like a Man Too,70181428,65182182,4999246,2014.csv,2014,92.9%,7.1%
1310,A Cinderella Story,70067909,51438175,18629734,2004.csv,2004,73.4%,26.6%
1311,The Cabin in the Woods 2012 Re-release,69935600,42073277,27862323,2012.csv,2012,60.2%,39.8%
1312,After,69733482,12138565,57594917,2019.csv,2019,17.4%,82.6%
1313,The Dilemma,69721966,48475290,21246676,2011.csv,2011,69.5%,30.5%
1314,Exit,69501772,470699,69031073,2019.csv,2019,0.7%,99.3%
1315,The Last Exorcism,69432527,41034350,28398177,2010.csv,2010,59.1%,40.9%
1316,A Very Long Engagement,69424389,6524389,62900000,2004.csv,2004,9.4%,90.6%
1317,13 Hours,69411370,52853219,16558151,2015.csv,2015,76.1%,23.9%
1318,Finding Nemo 2012 3D Release,69328283,41128283,28200000,2012.csv,2012,59.3%,40.7%
1319,E.T. the Extra-Terrestrial 20th Anniversary,69177751,35306015,33871736,2002.csv,2002,51%,49%
1320,Takers,69055695,57744720,11310975,2010.csv,2010,83.6%,16.4%
1321,Anna Karenina,68929150,12816367,56112783,2012.csv,2012,18.6%,81.4%
1322,Running Man,68782475,310978,68471497,2015.csv,2015,0.5%,99.5%
1323,House of Wax,68766121,32064800,36701321,2005.csv,2005,46.6%,53.4%
1324,The Nut Job 2: Nutty by Nature,68743485,28370522,40372963,2017.csv,2017,41.3%,58.7%
1325,The Sweetest Thing,68696770,24718164,43978606,2002.csv,2002,36%,64%
1326,Playing with Fire,68631669,44451847,24179822,2019.csv,2019,64.8%,35.2%
1327,The Call,68572631,51872378,16700253,2013.csv,2013,75.6%,24.4%
1328,One Direction: This Is Us,68532898,28873374,39659524,2013.csv,2013,42.1%,57.9%
1329,Looney Tunes: Back in Action,68514844,20991364,47523480,2003.csv,2003,30.6%,69.4%
1330,Thir13en Ghosts,68467960,41867960,26600000,2001.csv,2001,61.1%,38.9%
1331,Pokémon 3 the Movie: Spell of the Unown,68411275,17052128,51359147,2001.csv,2001,24.9%,75.1%
1332,Ghost Ship,68349884,30113491,38236393,2002.csv,2002,44.1%,55.9%
1333,Stalingrad,68316452,1013945,67302507,2013.csv,2013,1.5%,98.5%
1334,Open Range,68296293,58331254,9965039,2003.csv,2003,85.4%,14.6%
1335,The Watch,68267862,35353000,32914862,2012.csv,2012,51.8%,48.2%
1336,Moonrise Kingdom,68263166,45512466,22750700,2012.csv,2012,66.7%,33.3%
1337,Frequency,68106245,45010278,23095967,2000.csv,2000,66.1%,33.9%
1338,Shoplifters,67998954,3313513,64685441,2018.csv,2018,4.9%,95.1%
1339,Prime,67937494,22827153,45110341,2005.csv,2005,33.6%,66.4%
1340,Legion,67918658,40168080,27750578,2010.csv,2010,59.1%,40.9%
1341,The American,67876281,35606376,32269905,2010.csv,2010,52.5%,47.5%
1342,A Beautiful Day in the Neighborhood,67760877,61704055,6056822,2019.csv,2019,91.1%,8.9%
1343,Jersey Boys,67647013,47047013,20600000,2014.csv,2014,69.5%,30.5%
1344,Bandits,67631903,41575141,26056762,2001.csv,2001,61.5%,38.5%
1345,12 Strong,67450815,45819713,21631102,2018.csv,2018,67.9%,32.1%
1346,The Next Three Days,67448651,21148651,46300000,2010.csv,2010,31.4%,68.6%
1347,Star Trek: Nemesis,67336470,43254409,24082061,2002.csv,2002,64.2%,35.8%
1348,American Assassin,67234188,36249674,30984514,2017.csv,2017,53.9%,46.1%
1349,Boogeyman,67192859,46752382,20440477,2005.csv,2005,69.6%,30.4%
1350,War,67179155,4654000,62525155,2019.csv,2019,6.9%,93.1%
1351,Skyline,66984887,21393620,45591267,2010.csv,2010,31.9%,68.1%
1352,The Giver,66980456,45090374,21890082,2014.csv,2014,67.3%,32.7%
1353,Madea's Witness Protection,66899242,65653242,1246000,2012.csv,2012,98.1%,1.9%
1354,Selma,66787908,52076908,14711000,2014.csv,2014,78%,22%
1355,Thirteen Days,66579890,34592089,31987801,2000.csv,2000,52%,48%
1356,Victoria & Abdul,66558465,22245070,44313395,2017.csv,2017,33.4%,66.6%
1357,Not Another Teen Movie,66468332,38252284,28216048,2001.csv,2001,57.5%,42.5%
1358,"Love, Simon",66316289,40826341,25489948,2018.csv,2018,61.6%,38.4%
1359,Mile 22,66308758,36108758,30200000,2018.csv,2018,54.5%,45.5%
1360,One Piece Film: Gold,66207073,423593,65783480,2016.csv,2016,0.6%,99.4%
1361,Barbershop 2: Back in Business,65991448,65111277,880171,2004.csv,2004,98.7%,1.3%
1362,Bad Company,65977295,30160161,35817134,2002.csv,2002,45.7%,54.3%
1363,Life of the Party,65859911,53059911,12800000,2018.csv,2018,80.6%,19.4%
1364,Beijing Love Story,65842375,428318,65414057,2014.csv,2014,0.7%,99.3%
1365,Stuck on You,65784503,33832741,31951762,2003.csv,2003,51.4%,48.6%
1366,Sweet November,65754228,25288103,40466125,2001.csv,2001,38.5%,61.5%
1367,K-19: The Widowmaker,65716126,35168966,30547160,2002.csv,2002,53.5%,46.5%
1368,The Age of Adaline,65663276,42629776,23033500,2015.csv,2015,64.9%,35.1%
1369,Matchstick Men,65565672,36906460,28659212,2003.csv,2003,56.3%,43.7%
1370,Taxi 3,65497208,497208,65000000,2003.csv,2003,0.8%,99.2%
1371,Taking Lives,65470529,32682342,32788187,2004.csv,2004,49.9%,50.1%
1372,Moonlight,65336603,27854932,37481671,2016.csv,2016,42.6%,57.4%
1373,Something Borrowed,65100369,39046489,26053880,2011.csv,2011,60%,40%
1374,Zathura: A Space Adventure,65079104,29258869,35820235,2005.csv,2005,45%,55%
1375,K-PAX,65001485,50338485,14663000,2001.csv,2001,77.4%,22.6%
1376,Pirates,64858224,415775,64442449,2014.csv,2014,0.6%,99.4%
1377,Hot Tub Time Machine,64735752,50287556,14448196,2010.csv,2010,77.7%,22.3%
1378,God's Not Dead,64667874,60755732,3912142,2014.csv,2014,94%,6%
1379,The Darkest Hour,64626786,21443494,43183292,2011.csv,2011,33.2%,66.8%
1380,Happy Death Day 2U,64600152,28148130,36452022,2019.csv,2019,43.6%,56.4%
1381,Monster Trucks,64493915,33370166,31123749,2016.csv,2016,51.7%,48.3%
1382,Miracle,64445708,64378093,67615,2004.csv,2004,99.9%,0.1%
1383,Kiss of the Dragon,64437847,36845124,27592723,2001.csv,2001,57.2%,42.8%
1384,Fences,64414761,57682904,6731857,2016.csv,2016,89.5%,10.5%
1385,Capernaum,64413178,1661096,62752082,2018.csv,2018,2.6%,97.4%
1386,Zhongkui: Snow Girl and the Dark Crystal,64325947,165428,64160519,2015.csv,2015,0.3%,99.7%
1387,Isle of Dogs,64241499,32015231,32226268,2018.csv,2018,49.8%,50.2%
1388,Thunder and the House of Magic,64197205,4091,64193114,2013.csv,2013,<0.1%,100%
1389,The Danish Girl,64191523,11114018,53077505,2015.csv,2015,17.3%,82.7%
1390,The Boy,64188367,35819556,28368811,2015.csv,2015,55.8%,44.2%
1391,The Grandmaster,64076736,6594959,57481777,2013.csv,2013,10.3%,89.7%
1392,Hanna,63782078,40259119,23522959,2011.csv,2011,63.1%,36.9%
1393,High Crimes,63781810,41543917,22237893,2002.csv,2002,65.1%,34.9%
1394,"Hail, Caesar!",63647656,30498085,33149571,2016.csv,2016,47.9%,52.1%
1395,Elite Squad: The Enemy Within,63618850,100119,63518731,2010.csv,2010,0.2%,99.8%
1396,Footloose 2011 Re-release,63543328,51802742,11740586,2011.csv,2011,81.5%,18.5%
1397,Conan the Barbarian,63523283,21295021,42228262,2011.csv,2011,33.5%,66.5%
1398,Begin Again,63464861,16170632,47294229,2014.csv,2014,25.5%,74.5%
1399,Colombiana,63458440,36665854,26792586,2011.csv,2011,57.8%,42.2%
1400,Side Effects,63414135,32172757,31241378,2013.csv,2013,50.7%,49.3%
1401,The Host,63365859,26627201,36738658,2013.csv,2013,42%,58%
1402,Jeepers Creepers 2,63102666,35667218,27435448,2003.csv,2003,56.5%,43.5%
1403,The Longest Ride,62944815,37446117,25498698,2015.csv,2015,59.5%,40.5%
1404,Unfriended,62882090,32482090,30400000,2015.csv,2015,51.7%,48.3%
1405,Piglet's Big Movie,62870546,23103423,39767123,2003.csv,2003,36.7%,63.3%
1406,The Mountain Between Us,62832209,30348555,32483654,2017.csv,2017,48.3%,51.7%
1407,The Star,62812974,40852824,21960150,2017.csv,2017,65%,35%
1408,The Nice Guys,62788218,36261763,26526455,2016.csv,2016,57.8%,42.2%
1409,Beauty and the Beast 2012 3D Release,62767829,47617067,15150762,2012.csv,2012,75.9%,24.1%
1410,Proof of Life,62761005,32598931,30162074,2000.csv,2000,51.9%,48.1%
1411,Devil,62695489,33601190,29094299,2010.csv,2010,53.6%,46.4%
1412,Runner Runner,62675095,19316646,43358449,2013.csv,2013,30.8%,69.2%
1413,After the Sunset,62657868,28331233,34326635,2004.csv,2004,45.2%,54.8%
1414,How to Be a Latin Lover,62547032,32149404,30397628,2017.csv,2017,51.4%,48.6%
1415,Snow Day,62464731,60020107,2444624,2000.csv,2000,96.1%,3.9%
1416,Like Mike,62274780,51432760,10842020,2002.csv,2002,82.6%,17.4%
1417,Honey,62228395,30308417,31919978,2003.csv,2003,48.7%,51.3%
1418,28 Days,62198945,37170488,25028457,2000.csv,2000,59.8%,40.2%
1419,47 Meters Down,62187529,44307191,17880338,2017.csv,2017,71.2%,28.8%
1420,Two Brothers,62172050,19176754,42995296,2004.csv,2004,30.8%,69.2%
1421,Captain Corelli's Mandolin,62112895,25543895,36569000,2001.csv,2001,41.1%,58.9%
1422,Brooklyn,62076141,38322743,23753398,2015.csv,2015,61.7%,38.3%
1423,Friday Night Lights,61950770,61255921,694849,2004.csv,2004,98.9%,1.1%
1424,"Dragon Ball Z: Resurrection ""F""",61768190,8008363,53759827,2015.csv,2015,13%,87%
1425,Valiant,61746888,19478106,42268782,2005.csv,2005,31.5%,68.5%
1426,White Snake,61631776,34730,61597046,2019.csv,2019,<0.1%,99.9%
1427,"Everything, Everything",61621140,34121140,27500000,2017.csv,2017,55.4%,44.6%
1428,Woman in Gold,61619773,33307793,28311980,2015.csv,2015,54.1%,45.9%
1429,The Face Reader,61559184,515876,61043308,2013.csv,2013,0.8%,99.2%
1430,Krampus,61548707,42725475,18823232,2015.csv,2015,69.4%,30.6%
1431,From Up on Poppy Hill,61459425,1002895,60456530,2011.csv,2011,1.6%,98.4%
1432,A History of Violence,61385065,31504633,29880432,2005.csv,2005,51.3%,48.7%
1433,In Good Company,61315215,45806659,15508556,2004.csv,2004,74.7%,25.3%
1434,The Legend of Hercules,61279452,18848538,42430914,2013.csv,2013,30.8%,69.2%
1435,The Walk,61181942,10137502,51044440,2014.csv,2014,16.6%,83.4%
1436,Crossroads,61141030,37191304,23949726,2002.csv,2002,60.8%,39.2%
1437,Ma,61105672,45896028,15209644,2019.csv,2019,75.1%,24.9%
1438,Snatched,60845711,45852178,14993533,2017.csv,2017,75.4%,24.6%
1439,Kick-Ass 2,60795985,28795985,32000000,2013.csv,2013,47.4%,52.6%
1440,Zoolander,60780981,45172250,15608731,2001.csv,2001,74.3%,25.7%
1441,127 Hours,60738797,18335230,42403567,2010.csv,2010,30.2%,69.8%
1442,Taxi 2,60726164,626164,60100000,2000.csv,2000,1%,99%
1443,The Wild Thornberrys Movie,60694737,40108697,20586040,2002.csv,2002,66.1%,33.9%
1444,Why Did I Get Married Too?,60673972,60095852,578120,2010.csv,2010,99%,1%
1445,Evangelion: 3.0 You Can (Not) Redo,60488344,174945,60313399,2012.csv,2012,0.3%,99.7%
1446,21 Grams,60427839,16290476,44137363,2003.csv,2003,27%,73%
1447,The Ghost Writer,60331447,15541549,44789898,2010.csv,2010,25.8%,74.2%
1448,My Little Pony: The Movie,60330833,21885107,38445726,2017.csv,2017,36.3%,63.7%
1449,Secretariat,60321861,59713955,607906,2010.csv,2010,99%,1%
1450,The Perfect Guy,60273173,57027435,3245738,2015.csv,2015,94.6%,5.4%
1451,A Haunted House,60159584,40041683,20117901,2013.csv,2013,66.6%,33.4%
1452,The Crimson Rivers,60094966,594966,59500000,2001.csv,2001,1%,99%
1453,Beautiful Creatures,60052138,19452138,40600000,2013.csv,2013,32.4%,67.6%
1454,Morning Glory,60040976,31011732,29029244,2010.csv,2010,51.7%,48.3%
1455,Forever Young,59981902,149761,59832141,2015.csv,2015,0.2%,99.8%
1456,Son of the Mask,59981548,17018422,42963126,2005.csv,2005,28.4%,71.6%
1457,Keeping the Faith,59945183,37047880,22897303,2000.csv,2000,61.8%,38.2%
1458,Adrift,59945012,31445012,28500000,2018.csv,2018,52.5%,47.5%
1459,Next Friday,59827328,57328603,2498725,2000.csv,2000,95.8%,4.2%
1460,Bombshell,59588732,31762808,27825924,2019.csv,2019,53.3%,46.7%
1461,Quartet,59520298,18390117,41130181,2012.csv,2012,30.9%,69.1%
1462,The Flintstones in Viva Rock Vegas,59468275,35268275,24200000,2000.csv,2000,59.3%,40.7%
1463,Rock of Ages,59418613,38518613,20900000,2012.csv,2012,64.8%,35.2%
1464,Miss Granny,59396311,234573,59161738,2015.csv,2015,0.4%,99.6%
1465,One Day,59389433,13843771,45545662,2011.csv,2011,23.3%,76.7%
1466,Molly's Game,59284015,28780744,30503271,2017.csv,2017,48.5%,51.5%
1467,Jeepers Creepers,59217789,37904175,21313614,2001.csv,2001,64%,36%
1468,The Devotion of Suspect X,59035664,686435,58349229,2017.csv,2017,1.2%,98.8%
1469,The Gift,58978653,43787265,15191388,2015.csv,2015,74.2%,25.8%
1470,Under the Tuscan Sun,58878723,43610723,15268000,2003.csv,2003,74.1%,25.9%
1471,A Walk Among the Tombstones,58834384,26307600,32526784,2014.csv,2014,44.7%,55.3%
1472,Shock Wave,58815633,0,58815633,2017.csv,2017,-,100%
1473,Agent Cody Banks,58795814,47938330,10857484,2003.csv,2003,81.5%,18.5%
1474,Monster,58469210,34469210,24000000,2003.csv,2003,59%,41%
1475,The Tree of Life,58409247,13303319,45105928,2011.csv,2011,22.8%,77.2%
1476,The Ninth Gate,58401898,18661336,39740562,2000.csv,2000,32%,68%
1477,Beginning of the Great Revival,58309289,151000,58158289,2011.csv,2011,0.3%,99.7%
1478,Little Nicky,58292295,39464775,18827520,2000.csv,2000,67.7%,32.3%
1479,Must Love Dogs,58231520,43894863,14336657,2005.csv,2005,75.4%,24.6%
1480,Huo guo ying xiong,58106427,779818,57326609,2016.csv,2016,1.3%,98.7%
1481,L.O.R.D: Legend of Ravaging Dynasties,58089494,350456,57739038,2016.csv,2016,0.6%,99.4%
1482,Doom,58072119,28212337,29859782,2005.csv,2005,48.6%,51.4%
1483,Bowling for Columbine,58008423,21576018,36432405,2002.csv,2002,37.2%,62.8%
1484,Sky Captain and the World of Tomorrow,57947036,37762677,20184359,2004.csv,2004,65.2%,34.8%
1485,Snitch,57824674,42930462,14894212,2013.csv,2013,74.2%,25.8%
1486,Dolphin Tale 2,57824533,42024533,15800000,2014.csv,2014,72.7%,27.3%
1487,Nine Lives,57814445,19700032,38114413,2016.csv,2016,34.1%,65.9%
1488,Heartbreakers,57756408,40336607,17419801,2001.csv,2001,69.8%,30.2%
1489,That's My Boy,57719093,36931089,20788004,2012.csv,2012,64%,36%
1490,Cellular,57678321,32003620,25674701,2004.csv,2004,55.5%,44.5%
1491,The Motorcycle Diaries,57663224,16781387,40881837,2004.csv,2004,29.1%,70.9%
1492,Goldbuster,57628292,186135,57442157,2017.csv,2017,0.3%,99.7%
1493,Ready or Not,57615777,28714231,28901546,2019.csv,2019,49.8%,50.2%
1494,Drumline,57588485,56399184,1189301,2002.csv,2002,97.9%,2.1%
1495,Derailed,57479076,36024076,21455000,2005.csv,2005,62.7%,37.3%
1496,Walking Tall,57223890,46437717,10786173,2004.csv,2004,81.2%,18.8%
1497,Killer Elite,57084522,25124966,31959556,2011.csv,2011,44%,56%
1498,The 15:17 to Paris,57076286,36276286,20800000,2018.csv,2018,63.6%,36.4%
1499,The Descent,57051053,26024456,31026597,2005.csv,2005,45.6%,54.4%
1500,All the Money in the World,56996304,25113707,31882597,2017.csv,2017,44.1%,55.9%
1501,Elektra,56995646,24409722,32585924,2005.csv,2005,42.8%,57.2%
1502,Zoolander 2,56722693,28848693,27874000,2016.csv,2016,50.9%,49.1%
1503,Murder by Numbers,56714147,31945749,24768398,2002.csv,2002,56.3%,43.7%
1504,Cradle 2 the Grave,56489558,34712347,21777211,2003.csv,2003,61.4%,38.6%
1505,The Big Sick,56411585,42873127,13538458,2017.csv,2017,76%,24%
1506,15 Minutes,56359980,24403552,31956428,2001.csv,2001,43.3%,56.7%
1507,Frida,56298474,25885000,30413474,2002.csv,2002,46%,54%
1508,Kicking & Screaming,56070433,52842724,3227709,2005.csv,2005,94.2%,5.8%
1509,Remember Me,56032889,19068240,36964649,2010.csv,2010,34%,66%
1510,The Odd Life of Timothy Green,56012642,51854875,4157767,2012.csv,2012,92.6%,7.4%
1511,Confidential Assignment,55972241,475618,55496623,2017.csv,2017,0.8%,99.2%
1512,Dallas Buyers Club,55736588,27298285,28438303,2013.csv,2013,49%,51%
1513,Pay It Forward,55707411,33519628,22187783,2000.csv,2000,60.2%,39.8%
1514,All Eyez on Me,55668698,44922302,10746396,2017.csv,2017,80.7%,19.3%
1515,Cop Out,55611001,44875481,10735520,2010.csv,2010,80.7%,19.3%
1516,Lizzie McGuire,55534455,42734455,12800000,2003.csv,2003,77%,23%
1517,Out of Time,55495563,41088845,14406718,2003.csv,2003,74%,26%
1518,Spanglish,55470154,42726869,12743285,2004.csv,2004,77%,23%
1519,Lawless,55404159,37400127,18004032,2012.csv,2012,67.5%,32.5%
1520,Silent Hill: Revelation,55362705,17529157,37833548,2011.csv,2011,31.7%,68.3%
1521,Rugrats Go Wild,55250496,39402572,15847924,2003.csv,2003,71.3%,28.7%
1522,Extremely Loud & Incredibly Close,55247881,31847881,23400000,2011.csv,2011,57.6%,42.4%
1523,The Mothman Prophecies,55157539,35746370,19411169,2002.csv,2002,64.8%,35.2%
1524,End of Watch,55078146,41003371,14074775,2012.csv,2012,74.4%,25.6%
1525,Barbershop: The Next Cut,55030051,54030051,1000000,2016.csv,2016,98.2%,1.8%
1526,Downsizing,55003890,24449754,30554136,2017.csv,2017,44.5%,55.5%
1527,Analyze That,55003135,32130627,22872508,2002.csv,2002,58.4%,41.6%
1528,St. Vincent,54837234,44137712,10699522,2014.csv,2014,80.5%,19.5%
1529,The Three Stooges,54819301,44338224,10481077,2012.csv,2012,80.9%,19.1%
1530,The Crazies,54806823,39123589,15683234,2010.csv,2010,71.4%,28.6%
1531,Driven,54744738,32720065,22024673,2001.csv,2001,59.8%,40.2%
1532,The Punisher,54700105,33810189,20889916,2004.csv,2004,61.8%,38.2%
1533,Open Water,54683487,30610863,24072624,2004.csv,2004,56%,44%
1534,"Good Night, and Good Luck.",54641191,31558003,23083188,2005.csv,2005,57.8%,42.2%
1535,The Hot Chick,54639553,35081594,19557959,2002.csv,2002,64.2%,35.8%
1536,Early Man,54622814,8267544,46355270,2018.csv,2018,15.1%,84.9%
1537,The Age of Shadows,54491162,541719,53949443,2016.csv,2016,1%,99%
1538,No Escape,54418872,27288872,27130000,2015.csv,2015,50.1%,49.9%
1539,No Good Deed,54323210,52543632,1779578,2014.csv,2014,96.7%,3.3%
1540,Domestic Disturbance,54249294,45246095,9003199,2001.csv,2001,83.4%,16.6%
1541,The Five-Year Engagement,54169363,28835528,25333835,2012.csv,2012,53.2%,46.8%
1542,Madea's Big Happy Family,54161287,53345287,816000,2011.csv,2011,98.5%,1.5%
1543,"I, Tonya",53939297,30014539,23924758,2017.csv,2017,55.6%,44.4%
1544,Peppermint,53918723,35418723,18500000,2018.csv,2018,65.7%,34.3%
1545,Long Shot,53873809,30316271,23557538,2019.csv,2019,56.3%,43.7%
1546,Bounce,53425292,36805288,16620004,2000.csv,2000,68.9%,31.1%
1547,A Madea Christmas,53396635,52543354,853281,2013.csv,2013,98.4%,1.6%
1548,Sinister 2,53329150,27740955,25588195,2015.csv,2015,52%,48%
1549,Æon Flux,53321673,25874337,27447336,2005.csv,2005,48.5%,51.5%
1550,Little White Lies,53319615,206088,53113527,2010.csv,2010,0.4%,99.6%
1551,Radio,53293628,52333738,959890,2003.csv,2003,98.2%,1.8%
1552,3 Days to Kill,53260230,30697999,22562231,2014.csv,2014,57.6%,42.4%
1553,Pitch Black,53187659,39240659,13947000,2000.csv,2000,73.8%,26.2%
1554,Temptation: Confessions of a Marriage Counselor,53143144,51975354,1167790,2013.csv,2013,97.8%,2.2%
1555,Delivery Man,53120346,30664106,22456240,2013.csv,2013,57.7%,42.3%
1556,Big Fat Liar,52970014,48360547,4609467,2002.csv,2002,91.3%,8.7%
1557,Pooh's Heffalump Movie,52858433,18098433,34760000,2005.csv,2005,34.2%,65.8%
1558,From Paris with Love,52830951,24077427,28753524,2010.csv,2010,45.6%,54.4%
1559,Prem Ratan Dhan Payo,52715771,4364639,48351132,2015.csv,2015,8.3%,91.7%
1560,Wild,52501541,37880356,14621185,2014.csv,2014,72.2%,27.8%
1561,Tunnel,52444295,568876,51875419,2016.csv,2016,1.1%,98.9%
1562,The Boy Next Door,52425855,35423380,17002475,2015.csv,2015,67.6%,32.4%
1563,The Night Before,52395996,43047372,9348624,2015.csv,2015,82.2%,17.8%
1564,Dragonfly,52323400,30323400,22000000,2002.csv,2002,58%,42%
1565,One Hour Photo,52223306,31597131,20626175,2002.csv,2002,60.5%,39.5%
1566,Patriots Day,52185751,31886361,20299390,2016.csv,2016,61.1%,38.9%
1567,Elizabethtown,52164016,26850426,25313590,2005.csv,2005,51.5%,48.5%
1568,The Finest Hours,52099090,27569558,24529532,2016.csv,2016,52.9%,47.1%
1569,Teen Titans GO! to the Movies,52090236,29790236,22300000,2018.csv,2018,57.2%,42.8%
1570,Detective Dee: Mystery of the Phantom Flame,51899269,459836,51439433,2010.csv,2010,0.9%,99.1%
1571,Hanging Up,51880044,36050230,15829814,2000.csv,2000,69.5%,30.5%
1572,Blue Crush,51843679,40390647,11453032,2002.csv,2002,77.9%,22.1%
1573,Enough,51806184,40007742,11798442,2002.csv,2002,77.2%,22.8%
1574,Slender Man,51738549,30569484,21169065,2018.csv,2018,59.1%,40.9%
1575,Master,51636415,597251,51039164,2016.csv,2016,1.2%,98.8%
1576,Daybreakers,51416464,30101577,21314887,2010.csv,2010,58.5%,41.5%
1577,Breaking In,51411620,46840590,4571030,2018.csv,2018,91.1%,8.9%
1578,I Spy,51386477,33561137,17825340,2002.csv,2002,65.3%,34.7%
1579,Hot Pursuit,51380201,34580201,16800000,2015.csv,2015,67.3%,32.7%
1580,Once Upon a Deadpool 2018 Re-release,51247568,6100309,45147259,2018.csv,2018,11.9%,88.1%
1581,The 100 Year-Old Man Who Climbed Out the Window and Disappeared,51167572,944193,50223379,2013.csv,2013,1.8%,98.2%
1582,Hollywood Homicide,51142659,30940691,20201968,2003.csv,2003,60.5%,39.5%
1583,Magic in the Moonlight,51029361,10539326,40490035,2014.csv,2014,20.7%,79.3%
1584,Talk to Her 2002 Re-release,51001550,9285469,41716081,2002.csv,2002,18.2%,81.8%
1585,Red Dawn,50950296,44806783,6143513,2012.csv,2012,87.9%,12.1%
1586,Just Friends,50912434,32619671,18292763,2005.csv,2005,64.1%,35.9%
1587,Unleashed,50871113,24537621,26333492,2005.csv,2005,48.2%,51.8%
1588,Team America: World Police,50826898,32786074,18040824,2004.csv,2004,64.5%,35.5%
1589,The Skulls,50802120,35046120,15756000,2000.csv,2000,69%,31%
1590,What a Girl Wants,50732139,36105433,14626706,2003.csv,2003,71.2%,28.8%
1591,Diary of a Mad Black Woman,50652203,50633099,19104,2005.csv,2005,100%,<0.1%
1592,Fever Pitch,50605163,42071069,8534094,2005.csv,2005,83.1%,16.9%
1593,War of the Arrows,50587661,251200,50336461,2011.csv,2011,0.5%,99.5%
1594,You Got Served,50576805,40363810,10212995,2004.csv,2004,79.8%,20.2%
1595,The Himalayas,50544493,696717,49847776,2015.csv,2015,1.4%,98.6%
1596,Alpha and Omega,50507267,25107267,25400000,2010.csv,2010,49.7%,50.3%
1597,Dragon Ball Z: Battle of Gods,50461371,2553002,47908369,2013.csv,2013,5.1%,94.9%
1598,About Last Night,50445860,48637684,1808176,2014.csv,2014,96.4%,3.6%
1599,Breakthrough,50444358,40713082,9731276,2019.csv,2019,80.7%,19.3%
1600,Just Mercy,50401502,36001502,14400000,2019.csv,2019,71.4%,28.6%
1601,Red Tails,50365498,49876377,489121,2012.csv,2012,99%,1%
1602,"Monsters, Inc. 2012 3D Release",50207820,34043006,16164814,2012.csv,2012,67.8%,32.2%
1603,The Closet,50104745,6678894,43425851,2001.csv,2001,13.3%,86.7%
1604,National Security,50097949,36381186,13716763,2003.csv,2003,72.6%,27.4%
1605,The Replacements,50054511,44737059,5317452,2000.csv,2000,89.4%,10.6%
1606,Uncut Gems,50023780,50023780,0,2019.csv,2019,100%,-
1607,21 Bridges,49939757,28539757,21400000,2019.csv,2019,57.1%,42.9%
1608,Winnie the Pooh,49871429,26692846,23178583,2011.csv,2011,53.5%,46.5%
1609,The Wailing,49851770,786633,49065137,2016.csv,2016,1.6%,98.4%
1610,The Switch,49830607,27779426,22051181,2010.csv,2010,55.7%,44.3%
1611,She's Out of My League,49779728,32010860,17768868,2010.csv,2010,64.3%,35.7%
1612,Raising Helen,49718611,37486512,12232099,2004.csv,2004,75.4%,24.6%
1613,The Boy and the Beast,49714378,490643,49223735,2015.csv,2015,1%,99%
1614,Surprise,49567466,0,49567466,2015.csv,2015,-,100%
1615,Death Wish,49562710,34017028,15545682,2018.csv,2018,68.6%,31.4%
1616,The Grudge,49511319,21221803,28289516,2020.csv,2020,42.9%,57.1%
1617,Andhadhun,49391206,1193046,48198160,2018.csv,2018,2.4%,97.6%
1618,Capote,49327405,28750530,20576875,2005.csv,2005,58.3%,41.7%
1619,Entourage,49263404,32363404,16900000,2015.csv,2015,65.7%,34.3%
1620,Death at a Funeral,49050886,42739347,6311539,2010.csv,2010,87.1%,12.9%
1621,Little,48987096,40860481,8126615,2019.csv,2019,83.4%,16.6%
1622,Whiplash,48982041,13092000,35890041,2014.csv,2014,26.7%,73.3%
1623,So Young 2: Never Gone,48980792,96421,48884371,2016.csv,2016,0.2%,99.8%
1624,The Berlin File,48972848,665210,48307638,2013.csv,2013,1.4%,98.6%
1625,Trouble with the Curve,48963137,35763137,13200000,2012.csv,2012,73%,27%
1626,Luck-Key,48913975,466505,48447470,2016.csv,2016,1%,99%
1627,Florence Foster Jenkins,48902953,27383770,21519183,2016.csv,2016,56%,44%
1628,The Woman in Black 2: Angel of Death,48854305,26501323,22352982,2015.csv,2015,54.2%,45.8%
1629,Isn't It Romantic,48791187,48791187,0,2019.csv,2019,100%,-
1630,Mother's Day,48782670,32492859,16289811,2016.csv,2016,66.6%,33.4%
1631,How Do You Know,48668907,30212620,18456287,2010.csv,2010,62.1%,37.9%
1632,Concussion,48623572,34542474,14081098,2015.csv,2015,71%,29%
1633,Fantasy Island,48607556,26441782,22165774,2020.csv,2020,54.4%,45.6%
1634,Fat Albert,48551322,48116322,435000,2004.csv,2004,99.1%,0.9%
1635,Her,48517427,25568251,22949176,2013.csv,2013,52.7%,47.3%
1636,Logan Lucky,48453605,27780977,20672628,2017.csv,2017,57.3%,42.7%
1637,Homefront,48449416,20158898,28290518,2013.csv,2013,41.6%,58.4%
1638,Chef,48428048,31424003,17004045,2014.csv,2014,64.9%,35.1%
1639,Boo 2! A Madea Halloween,48333932,47319572,1014360,2017.csv,2017,97.9%,2.1%
1640,The Last Stand,48330757,12050299,36280458,2013.csv,2013,24.9%,75.1%
1641,Secondhand Lions,48249017,42070939,6178078,2003.csv,2003,87.2%,12.8%
1642,Charlie St. Cloud,48190704,31162545,17028159,2010.csv,2010,64.7%,35.3%
1643,Arthur,48147945,33035397,15112548,2011.csv,2011,68.6%,31.4%
1644,Boyhood,48137666,25352281,22785385,2014.csv,2014,52.7%,47.3%
1645,21 & Over,48065672,25682380,22383292,2013.csv,2013,53.4%,46.6%
1646,Countdown,48021766,25621766,22400000,2019.csv,2019,53.4%,46.6%
1647,"Yo-kai Watch Movie: It's the Secret of Birth, Meow! 2016 Re-release",47899805,257343,47642462,2016.csv,2016,0.5%,99.5%
1648,Phantom Thread,47756590,21198205,26558385,2017.csv,2017,44.4%,55.6%
1649,Book of Shadows: Blair Witch 2,47737094,26437094,21300000,2000.csv,2000,55.4%,44.6%
1650,Scott Pilgrim vs. the World,47664559,31524275,16140284,2010.csv,2010,66.1%,33.9%
1651,Man on a Ledge,47636031,18620000,29016031,2012.csv,2012,39.1%,60.9%
1652,Coming Home,47587984,377607,47210377,2014.csv,2014,0.8%,99.2%
1653,A Walk to Remember,47494916,41281092,6213824,2002.csv,2002,86.9%,13.1%
1654,Queen & Slim,47489558,43808310,3681248,2019.csv,2019,92.2%,7.8%
1655,Darkness Falls,47488536,32551396,14937140,2003.csv,2003,68.5%,31.5%
1656,Beauty and the Beast,47430624,0,47430624,2014.csv,2014,-,100%
1657,Nightcrawler,47398992,32381217,15017775,2014.csv,2014,68.3%,31.7%
1658,Almost Famous,47383689,32534850,14848839,2000.csv,2000,68.7%,31.3%
1659,Rough Night,47347283,22105643,25241640,2017.csv,2017,46.7%,53.3%
1660,Texas Chainsaw 3D,47340586,34341945,12998641,2013.csv,2013,72.5%,27.5%
1661,Broken Flowers,47329961,13744960,33585001,2005.csv,2005,29%,71%
1662,A Monster Calls,47309313,3740823,43568490,2016.csv,2016,7.9%,92.1%
1663,Tiny Times 2.0,47289937,43788,47246149,2013.csv,2013,<0.1%,99.9%
1664,Golden Job,47279677,285795,46993882,2018.csv,2018,0.6%,99.4%
1665,Mortdecai,47275695,7696134,39579561,2015.csv,2015,16.3%,83.7%
1666,The Watcher,47267829,28946615,18321214,2000.csv,2000,61.2%,38.8%
1667,High Fidelity,47126295,27287137,19839158,2000.csv,2000,57.9%,42.1%
1668,Soul Surfer,47120948,43853424,3267524,2011.csv,2011,93.1%,6.9%
1669,The Wedding Date,47096206,31726995,15369211,2005.csv,2005,67.4%,32.6%
1670,Land of the Dead,47074133,20700082,26374051,2005.csv,2005,44%,56%
1671,Dracula 2000,47053625,33022767,14030858,2000.csv,2000,70.2%,29.8%
1672,The Place Beyond the Pines,47052899,21403519,25649380,2013.csv,2013,45.5%,54.5%
1673,Son of Bigfoot,47046281,289308,46756973,2017.csv,2017,0.6%,99.4%
1674,Parker,46922566,17616641,29305925,2013.csv,2013,37.5%,62.5%
1675,Midsommar,46850563,27426361,19424202,2019.csv,2019,58.5%,41.5%
1676,47 Meters Down: Uncaged,46783103,22260900,24522203,2019.csv,2019,47.6%,52.4%
1677,Mary Queen of Scots,46710283,16468499,30241784,2018.csv,2018,35.3%,64.7%
1678,Uncle Drew,46664414,42469946,4194468,2018.csv,2018,91%,9%
1679,Get Rich or Die Tryin',46563961,30985352,15578609,2005.csv,2005,66.5%,33.5%
1680,Torque,46546197,21215059,25331138,2003.csv,2003,45.6%,54.4%
1681,The Big Wedding,46522137,21819348,24702789,2013.csv,2013,46.9%,53.1%
1682,Risen,46432579,36880033,9552546,2016.csv,2016,79.4%,20.6%
1683,Tyler Perry's Acrimony,46403669,43549096,2854573,2018.csv,2018,93.8%,6.2%
1684,A Werewolf Boy,46282588,342922,45939666,2012.csv,2012,0.7%,99.3%
1685,The Thousand Faces of Dunjia,46263237,124187,46139050,2017.csv,2017,0.3%,99.7%
1686,Asterix: The Secret of the Magic Potion,46221204,1271953,44949251,2018.csv,2018,2.8%,97.2%
1687,The Fog,46201432,29550869,16650563,2005.csv,2005,64%,36%
1688,The Battleship Island,46183383,1104957,45078426,2017.csv,2017,2.4%,97.6%
1689,Eddie the Eagle,46152800,15789389,30363411,2016.csv,2016,34.2%,65.8%
1690,Napoleon Dynamite,46118097,44540956,1577141,2004.csv,2004,96.6%,3.4%
1691,Into the Blue,46117696,18801234,27316462,2005.csv,2005,40.8%,59.2%
1692,The World's End,46089287,26004851,20084436,2013.csv,2013,56.4%,43.6%
1693,The Hunted,46061847,34244097,11817750,2003.csv,2003,74.3%,25.7%
1694,Let's Get Married,45972724,462918,45509806,2015.csv,2015,1%,99%
1695,Eight Legged Freaks,45867333,17322606,28544727,2002.csv,2002,37.8%,62.2%
1696,Avatar 2010 Special Edition,45823494,10741486,35082008,2010.csv,2010,23.4%,76.6%
1697,Somewhere Only We Know,45737711,482341,45255370,2015.csv,2015,1.1%,98.9%
1698,Chasing the Dragon II: Wild Wild Bunch,45733356,196634,45536722,2019.csv,2019,0.4%,99.6%
1699,"McFarland, USA",45710059,44482410,1227649,2015.csv,2015,97.3%,2.7%
1700,Earth to Echo,45681062,38934842,6746220,2014.csv,2014,85.2%,14.8%
1701,That Awkward Moment,45640143,26068955,19571188,2014.csv,2014,57.1%,42.9%
1702,The Debt,45636368,31177548,14458820,2011.csv,2011,68.3%,31.7%
1703,Hero,45565534,88675,45476859,2015.csv,2015,0.2%,99.8%
1704,Machete,45491656,26593646,18898010,2010.csv,2010,58.5%,41.5%
1705,Queen of the Damned,45479110,30336800,15142310,2002.csv,2002,66.7%,33.3%
1706,Wei ai zhi jian ru jia jing,45386560,271734,45114826,2014.csv,2014,0.6%,99.4%
1707,Good Boy,45312217,37667746,7644471,2003.csv,2003,83.1%,16.9%
1708,Blair Witch,45173154,20777061,24396093,2016.csv,2016,46%,54%
1709,Flatliners,45158254,16883115,28275139,2017.csv,2017,37.4%,62.6%
1710,Deuce Bigalow: European Gigolo,45109561,22400154,22709407,2005.csv,2005,49.7%,50.3%
1711,Monster's Ball,44909486,31273922,13635564,2001.csv,2001,69.6%,30.4%
1712,Grudge Match,44907260,29807260,15100000,2013.csv,2013,66.4%,33.6%
1713,Child's Play,44902237,29208403,15693834,2019.csv,2019,65%,35%
1714,Still Alice,44779195,18754371,26024824,2015.csv,2015,41.9%,58.1%
1715,The Man from Nowhere,44723232,528175,44195057,2010.csv,2010,1.2%,98.8%
1716,Hellboy,44664690,21903748,22760942,2019.csv,2019,49%,51%
1717,Uptown Girls,44617342,37182494,7434848,2003.csv,2003,83.3%,16.7%
1718,The Gift,44567606,12008642,32558964,2000.csv,2000,26.9%,73.1%
1719,Mother!,44516999,17800004,26716995,2017.csv,2017,40%,60%
1720,Recess: School's Out,44460850,36706141,7754709,2001.csv,2001,82.6%,17.4%
1721,Oculus,44446287,27695246,16751041,2014.csv,2014,62.3%,37.7%
1722,A Man Apart,44350926,26736098,17614828,2003.csv,2003,60.3%,39.7%
1723,Dark Water 2005 Re-release,44347079,25473352,18873727,2005.csv,2005,57.4%,42.6%
1724,House at the End of the Street,44287131,31611916,12675215,2012.csv,2012,71.4%,28.6%
1725,Hardball,44102389,40222729,3879660,2001.csv,2001,91.2%,8.8%
1726,Winchester,44019588,25091816,18927772,2018.csv,2018,57%,43%
1727,Wind River,43980821,33800859,10179962,2017.csv,2017,76.9%,23.1%
1728,Max,43967255,42656255,1311000,2015.csv,2015,97%,3%
1729,Timeline,43935763,19481943,24453820,2003.csv,2003,44.3%,55.7%
1730,The Transporter,43928932,25296447,18632485,2002.csv,2002,57.6%,42.4%
1731,Battle of Memories,43892362,594552,43297810,2017.csv,2017,1.4%,98.6%
1732,Of Gods and Men,43803417,3951596,39851821,2010.csv,2010,9%,91%
1733,Café Society,43763247,11103205,32660042,2016.csv,2016,25.4%,74.6%
1734,Richard Jewell,43745542,22345542,21400000,2019.csv,2019,51.1%,48.9%
1735,The Duff,43709744,34030343,9679401,2015.csv,2015,77.9%,22.1%
1736,The Sea Inside,43685449,2104923,41580526,2004.csv,2004,4.8%,95.2%
1737,Boy,43551154,256211,43294943,2010.csv,2010,0.6%,99.4%
1738,League of Gods,43498766,181633,43317133,2016.csv,2016,0.4%,99.6%
1739,The Master of Disguise,43411001,40388794,3022207,2002.csv,2002,93%,7%
1740,In the Bedroom,43368779,35930604,7438175,2001.csv,2001,82.8%,17.2%
1741,Orange County,43325009,41076018,2248991,2002.csv,2002,94.8%,5.2%
1742,Harriet,43282155,43082155,200000,2019.csv,2019,99.5%,0.5%
1743,Beastly,43202283,27865571,15336712,2011.csv,2011,64.5%,35.5%
1744,The Snowman,43155261,6700035,36455226,2017.csv,2017,15.5%,84.5%
1745,Annihilation,43070915,32732301,10338614,2018.csv,2018,76%,24%
1746,See Spot Run,43057552,33357476,9700076,2001.csv,2001,77.5%,22.5%
1747,When in Rome,43053376,32680633,10372743,2010.csv,2010,75.9%,24.1%
1748,Gifted,43046590,24801212,18245378,2017.csv,2017,57.6%,42.4%
1749,The Possession of Hannah Grace,43016528,14837422,28179106,2018.csv,2018,34.5%,65.5%
1750,Legend,42972994,1872994,41100000,2015.csv,2015,4.4%,95.6%
1751,The Gallows,42964410,22764410,20200000,2015.csv,2015,53%,47%
1752,A Lot Like Love,42886719,21845719,21041000,2005.csv,2005,50.9%,49.1%
1753,Basic,42792561,26793311,15999250,2003.csv,2003,62.6%,37.4%
1754,Shaolin Soccer,42776760,489600,42287160,2001.csv,2001,1.1%,98.9%
1755,Shaolin,42741494,66099,42675395,2011.csv,2011,0.2%,99.8%
1756,Almost Christmas,42580920,42158780,422140,2016.csv,2016,99%,1%
1757,Oliver Twist,42580321,2080321,40500000,2005.csv,2005,4.9%,95.1%
1758,Love the Coopers,42426912,26302731,16124181,2015.csv,2015,62%,38%
1759,8 Women,42426583,3098776,39327807,2002.csv,2002,7.3%,92.7%
1760,My Name Is Khan,42345360,4018771,38326589,2010.csv,2010,9.5%,90.5%
1761,Loving Vincent,42187665,6735118,35452547,2017.csv,2017,16%,84%
1762,Long Day's Journey Into Night,42140994,521365,41619629,2018.csv,2018,1.2%,98.8%
1763,Jobs,42128352,16131410,25996942,2013.csv,2013,38.3%,61.7%
1764,Judy,42077304,24313888,17763416,2019.csv,2019,57.8%,42.2%
1765,Going the Distance,42059111,17804299,24254812,2010.csv,2010,42.3%,57.7%
1766,Bang Bang,42045981,2546172,39499809,2014.csv,2014,6.1%,93.9%
1767,The Sisterhood of the Traveling Pants,42013878,39053061,2960817,2005.csv,2005,93%,7%
1768,Mary and the Witch's Flower,41978431,2418404,39560027,2017.csv,2017,5.8%,94.2%
1769,"As Above, So Below",41898409,21321100,20577309,2014.csv,2014,50.9%,49.1%
1770,Call Me by Your Name,41887595,18095701,23791894,2017.csv,2017,43.2%,56.8%
1771,The Guilt Trip,41863726,37134215,4729511,2012.csv,2012,88.7%,11.3%
1772,Wimbledon,41682237,17001133,24681104,2004.csv,2004,40.8%,59.2%
1773,T2 Trainspotting,41681746,2402004,39279742,2017.csv,2017,5.8%,94.2%
1774,Overlord,41657844,21704844,19953000,2018.csv,2018,52.1%,47.9%
1775,Born to Be Wild,41644475,25978556,15665919,2011.csv,2011,62.4%,37.6%
1776,Undercover Brother,41604473,39089928,2514545,2002.csv,2002,94%,6%
1777,Safe,41564670,17142080,24422590,2012.csv,2012,41.2%,58.8%
1778,The Great Battle,41509280,472166,41037114,2018.csv,2018,1.1%,98.9%
1779,The Lady in the Van,41387687,10021175,31366512,2015.csv,2015,24.2%,75.8%
1780,Shark Night 3D,41363927,18877153,22486774,2011.csv,2011,45.6%,54.4%
1781,Ricki and the Flash,41325328,26822144,14503184,2015.csv,2015,64.9%,35.1%
1782,Pinocchio,41314585,3675719,37638866,2002.csv,2002,8.9%,91.1%
1783,This Is Where I Leave You,41296320,34296320,7000000,2014.csv,2014,83%,17%
1784,The Darkest Minds,41142379,12695691,28446688,2018.csv,2018,30.9%,69.1%
1785,50/50,41097853,35014192,6083661,2011.csv,2011,85.2%,14.8%
1786,Fist Fight,41087017,32187017,8900000,2017.csv,2017,78.3%,21.7%
1787,Whale Rider,41062976,20779666,20283310,2003.csv,2003,50.6%,49.4%
1788,Dredd,41037742,13414714,27623028,2012.csv,2012,32.7%,67.3%
1789,Fright Night,41002607,18302607,22700000,2011.csv,2011,44.6%,55.4%
1790,Twisted,40954603,25198598,15756005,2004.csv,2004,61.5%,38.5%
1791,Drive Angry,40909909,10721033,30188876,2011.csv,2011,26.2%,73.8%
1792,Underwater,40882928,17291078,23591850,2020.csv,2020,42.3%,57.7%
1793,Where the Heart Is,40863718,33772838,7090880,2000.csv,2000,82.6%,17.4%
1794,Fighting with My Family,40810036,22958886,17851150,2019.csv,2019,56.3%,43.7%
1795,30 Minutes or Less,40662632,37053924,3608708,2011.csv,2011,91.1%,8.9%
1796,The Circle,40656399,20497844,20158555,2017.csv,2017,50.4%,49.6%
1797,The Roommate,40492652,37300000,3192652,2011.csv,2011,92.1%,7.9%
1798,Holmes & Watson,40466970,30573626,9893344,2018.csv,2018,75.6%,24.4%
1799,Serenity,40445129,25514517,14930612,2005.csv,2005,63.1%,36.9%
1800,Bless the Child,40443010,29381494,11061516,2000.csv,2000,72.6%,27.4%
1801,The Ringer,40442443,35428675,5013768,2005.csv,2005,87.6%,12.4%
1802,The Witch,40423945,25138705,15285240,2016.csv,2016,62.2%,37.8%
1803,The Art of War,40400425,30208599,10191826,2000.csv,2000,74.8%,25.2%
1804,Bad Education,40350837,5211842,35138995,2004.csv,2004,12.9%,87.1%
1805,Magnificent Desolation: Walking on the Moon 3D,40339402,34137524,6201878,2005.csv,2005,84.6%,15.4%
1806,Carol,40272135,12711491,27560644,2015.csv,2015,31.6%,68.4%
1807,Crimson Rivers 2: Angels of the Apocalypse,40152148,152148,40000000,2004.csv,2004,0.4%,99.6%
1808,Diary of a Wimpy Kid: The Long Haul,40140972,20738724,19402248,2017.csv,2017,51.7%,48.3%
1809,The Wild Life,40075446,8005586,32069860,2016.csv,2016,20%,80%
1810,Northern Limit Line,40034677,337907,39696770,2015.csv,2015,0.8%,99.2%
1811,Dancer in the Dark,40031879,4184036,35847843,2000.csv,2000,10.5%,89.5%
1812,Dream House,39984400,21302340,18682060,2011.csv,2011,53.3%,46.7%
1813,Black Knight,39976235,33426971,6549264,2001.csv,2001,83.6%,16.4%
1814,Brotherhood of Blades 2,39966092,14204,39951888,2017.csv,2017,<0.1%,100%
1815,Monte Carlo,39782683,23186769,16595914,2011.csv,2011,58.3%,41.7%
1816,Memento,39723096,25544867,14178229,2001.csv,2001,64.3%,35.7%
1817,The Forest,39712000,26594261,13117739,2016.csv,2016,67%,33%
1818,The November Man,39661919,25018119,14643800,2014.csv,2014,63.1%,36.9%
1819,Down with Love,39468111,20305251,19162860,2003.csv,2003,51.4%,48.6%
1820,The Legend of Bagger Vance,39459427,30919168,8540259,2000.csv,2000,78.4%,21.6%
1821,Don Jon,39439355,24477704,14961651,2013.csv,2013,62.1%,37.9%
1822,Crocodile Dundee in Los Angeles,39438674,25635682,13802992,2001.csv,2001,65%,35%
1823,Sin City: A Dame to Kill For,39407616,13757804,25649812,2014.csv,2014,34.9%,65.1%
1824,The Gambler,39280992,33680992,5600000,2014.csv,2014,85.7%,14.3%
1825,Dumb and Dumberer: When Harry Met Lloyd,39267515,26276465,12991050,2003.csv,2003,66.9%,33.1%
1826,Mars Needs Moms,39233678,21392758,17840920,2011.csv,2011,54.5%,45.5%
1827,Absolutely Fabulous: The Movie,39219109,4772155,34446954,2016.csv,2016,12.2%,87.8%
1828,Samba,39178695,151530,39027165,2014.csv,2014,0.4%,99.6%
1829,Show Dogs,39156854,17857020,21299834,2018.csv,2018,45.6%,54.4%
1830,Women Who Flirt,39156132,375495,38780637,2014.csv,2014,1%,99%
1831,Haunted Castle,39093166,13651656,25441510,2001.csv,2001,34.9%,65.1%
1832,Believer,39047153,365639,38681514,2018.csv,2018,0.9%,99.1%
1833,The Life of David Gale,38955598,19955598,19000000,2003.csv,2003,51.2%,48.8%
1834,The Spy Gone North,38844509,500803,38343706,2018.csv,2018,1.3%,98.7%
1835,Criminal,38803993,14708696,24095297,2015.csv,2015,37.9%,62.1%
1836,Clockstoppers,38793283,36989956,1803327,2002.csv,2002,95.4%,4.6%
1837,Dreamer: Inspired by a True Story,38741732,32751093,5990639,2005.csv,2005,84.5%,15.5%
1838,Someone Like You,38689940,27343067,11346873,2001.csv,2001,70.7%,29.3%
1839,On the Basis of Sex,38673750,24622687,14051063,2018.csv,2018,63.7%,36.3%
1840,"Crouching Tiger, Hidden Dragon: Sword of Destiny",38659039,0,38659039,2016.csv,2016,-,100%
1841,Head of State,38620484,38125247,495237,2003.csv,2003,98.7%,1.3%
1842,The Best of Me,38609668,26766213,11843455,2014.csv,2014,69.3%,30.7%
1843,Urban Legends: Final Cut,38574362,21468807,17105555,2000.csv,2000,55.7%,44.3%
1844,Million Dollar Arm,38483455,36457627,2025828,2014.csv,2014,94.7%,5.3%
1845,What's the Worst That Could Happen?,38464131,32269834,6194297,2001.csv,2001,83.9%,16.1%
1846,Chernobyl Diaries,38390020,18119640,20270380,2012.csv,2012,47.2%,52.8%
1847,The Missing,38364277,27011180,11353097,2003.csv,2003,70.4%,29.6%
1848,Boruto: Naruto the Movie,38362448,919651,37442797,2015.csv,2015,2.4%,97.6%
1849,The Lazarus Effect,38356892,25801570,12555322,2015.csv,2015,67.3%,32.7%
1850,Van Wilder: Party Liaison,38275483,21305259,16970224,2002.csv,2002,55.7%,44.3%
1851,Don't Be Afraid of the Dark,38269529,24046682,14222847,2011.csv,2011,62.8%,37.2%
1852,The Original Kings of Comedy,38182790,38182790,0,2000.csv,2000,100%,-
1853,The Water Diviner,38176317,4196641,33979676,2014.csv,2014,11%,89%
1854,Jumping the Broom,38158601,37295394,863207,2011.csv,2011,97.7%,2.3%
1855,One for the Money,38080789,26414527,11666262,2011.csv,2011,69.4%,30.6%
1856,The Producers,38075318,19398532,18676786,2005.csv,2005,50.9%,49.1%
1857,The Banger Sisters,38068353,30307416,7760937,2002.csv,2002,79.6%,20.4%
1858,But Always,38039248,430760,37608488,2014.csv,2014,1.1%,98.9%
1859,Overcomer,38026103,34746945,3279158,2019.csv,2019,91.4%,8.6%
1860,The Eagle,37989684,19490041,18499643,2011.csv,2011,51.3%,48.7%
1861,For Colored Girls,37981984,37729698,252286,2010.csv,2010,99.3%,0.7%
1862,Killing Them Softly,37930465,15026056,22904409,2012.csv,2012,39.6%,60.4%
1863,Hell or High Water,37879877,27007844,10872033,2016.csv,2016,71.3%,28.7%
1864,Bulletproof Monk,37713879,23358708,14355171,2003.csv,2003,61.9%,38.1%
1865,The Handmaiden,37692886,2006788,35686098,2016.csv,2016,5.3%,94.7%
1866,Casanova,37691644,11304403,26387241,2005.csv,2005,30%,70%
1867,The Prince and Me,37666766,28176497,9490269,2004.csv,2004,74.8%,25.2%
1868,Halloween: Resurrection,37664855,30354442,7310413,2002.csv,2002,80.6%,19.4%
1869,Pokémon the Movie: I Choose You!,37552144,2401722,35150422,2017.csv,2017,6.4%,93.6%
1870,A Walk in the Woods,37461274,29504281,7956993,2015.csv,2015,78.8%,21.2%
1871,Snowden,37357216,21587519,15769697,2016.csv,2016,57.8%,42.2%
1872,The Majestic,37317558,27807266,9510292,2001.csv,2001,74.5%,25.5%
1873,Home Again,37270721,27020284,10250437,2017.csv,2017,72.5%,27.5%
1874,Beauty Shop,37245453,36351350,894103,2005.csv,2005,97.6%,2.4%
1875,"Like Father, Like Son",37170163,334616,36835547,2013.csv,2013,0.9%,99.1%
1876,Pain and Glory,37137074,4567338,32569736,2019.csv,2019,12.3%,87.7%
1877,Till The End Of The World,37013733,118660,36895073,2018.csv,2018,0.3%,99.7%
1878,Devil's Due,36921560,15821461,21100099,2014.csv,2014,42.9%,57.1%
1879,Ex Machina,36869414,25442958,11426456,2015.csv,2015,69%,31%
1880,The Adventurers,36796816,216556,36580260,2017.csv,2017,0.6%,99.4%
1881,Titan A.E.,36754634,22753426,14001208,2000.csv,2000,61.9%,38.1%
1882,Valentine,36684136,20384136,16300000,2001.csv,2001,55.6%,44.4%
1883,Joy Ride,36642838,21974919,14667919,2001.csv,2001,60%,40%
1884,Return to Me,36609995,32722798,3887197,2000.csv,2000,89.4%,10.6%
1885,Burnt,36606743,13651946,22954797,2015.csv,2015,37.3%,62.7%
1886,The Intruder,36599361,35419122,1180239,2019.csv,2019,96.8%,3.2%
1887,The Priests,36577134,185093,36392041,2015.csv,2015,0.5%,99.5%
1888,Furry Vengeance,36288132,17630465,18657667,2010.csv,2010,48.6%,51.4%
1889,A Most Wanted Man,36233517,17237855,18995662,2014.csv,2014,47.6%,52.4%
1890,A Very Harold & Kumar 3D Christmas,36192775,35061031,1131744,2011.csv,2011,96.9%,3.1%
1891,Nothing to Lose,36075317,1016188,35059129,2018.csv,2018,2.8%,97.2%
1892,Kundo: Age of the Rampant,35941291,280958,35660333,2014.csv,2014,0.8%,99.2%
1893,Ra.One,35911689,2511689,33400000,2011.csv,2011,7%,93%
1894,Mia and the White Lion,35906887,399471,35507416,2018.csv,2018,1.1%,98.9%
1895,You Will Meet a Tall Dark Stranger,35867322,3248246,32619076,2010.csv,2010,9.1%,90.9%
1896,Garden State,35825316,26782316,9043000,2004.csv,2004,74.8%,25.2%
1897,Conquest 1453,35797045,35730,35761315,2012.csv,2012,<0.1%,99.9%
1898,Riding in Cars with Boys,35743308,30165536,5577772,2001.csv,2001,84.4%,15.6%
1899,Tad the Lost Explorer and the Secret of King Midas,35704046,5874,35698172,2017.csv,2017,<0.1%,100%
1900,Hostiles,35669017,29819114,5849903,2017.csv,2017,83.6%,16.4%
1901,Faster,35626958,23240020,12386938,2010.csv,2010,65.2%,34.8%
1902,Good Deeds,35579177,35025791,553386,2012.csv,2012,98.4%,1.6%
1903,My Dog Skip,35547761,34134641,1413120,2000.csv,2000,96%,4%
1904,Jersey Girl,35492921,25268157,10224764,2004.csv,2004,71.2%,28.8%
1905,Arbitrage,35485056,7919574,27565482,2012.csv,2012,22.3%,77.7%
1906,Original Sin,35402320,16534221,18868099,2001.csv,2001,46.7%,53.3%
1907,Room,35401758,14677654,20724104,2015.csv,2015,41.5%,58.5%
1908,Namiya,35351623,70814,35280809,2017.csv,2017,0.2%,99.8%
1909,Assault on Precinct 13,35294470,20040895,15253575,2005.csv,2005,56.8%,43.2%
1910,Eye in the Sky,35259653,18704595,16555058,2016.csv,2016,53%,47%
1911,Courageous,35185884,34522221,663663,2011.csv,2011,98.1%,1.9%
1912,The Girl in the Spider's Web,35164920,14841338,20323582,2018.csv,2018,42.2%,57.8%
1913,The Adventures of Rocky & Bullwinkle,35134820,26005820,9129000,2000.csv,2000,74%,26%
1914,Alfie,35060882,13399812,21661070,2004.csv,2004,38.2%,61.8%
1915,My Week with Marilyn,35057696,14600347,20457349,2011.csv,2011,41.6%,58.4%
1916,Flight of the Phoenix,35021497,21009180,14012317,2004.csv,2004,60%,40%
1917,When Marnie Was There,34949567,561085,34388482,2014.csv,2014,1.6%,98.4%
1918,The Sitter,34942188,30441326,4500862,2011.csv,2011,87.1%,12.9%
1919,The Hate U Give,34934009,29719483,5214526,2018.csv,2018,85.1%,14.9%
1920,Lost and Love,34930177,188817,34741360,2015.csv,2015,0.5%,99.5%
1921,Secret in Their Eyes,34854990,20180155,14674835,2015.csv,2015,57.9%,42.1%
1922,Chimpanzee,34823764,28972764,5851000,2012.csv,2012,83.2%,16.8%
1923,Kidnap,34814102,30971040,3843062,2017.csv,2017,89%,11%
1924,The Life Aquatic with Steve Zissou,34808403,24020403,10788000,2004.csv,2004,69%,31%
1925,Broken City,34737199,19701164,15036035,2013.csv,2013,56.7%,43.3%
1926,Endless Love,34718173,23438250,11279923,2014.csv,2014,67.5%,32.5%
1927,Jane Eyre,34710627,11242660,23467967,2011.csv,2011,32.4%,67.6%
1928,The Kids Are All Right,34705850,20811365,13894485,2010.csv,2010,60%,40%
1929,Malibu's Most Wanted,34622504,34432201,190303,2003.csv,2003,99.5%,0.5%
1930,Alex Cross,34618867,25888412,8730455,2012.csv,2012,74.8%,25.2%
1931,Salmon Fishing in the Yemen,34564651,9047981,25516670,2012.csv,2012,26.2%,73.8%
1932,Haywire,34513760,18942396,15571364,2012.csv,2012,54.9%,45.1%
1933,Steve Jobs,34441873,17766658,16675215,2015.csv,2015,51.6%,48.4%
1934,Swimfan,34411240,28564995,5846245,2002.csv,2002,83%,17%
1935,The Medallion,34268701,22219192,12049509,2003.csv,2003,64.8%,35.2%
1936,American Psycho,34266564,15070285,19196279,2000.csv,2000,44%,56%
1937,Wild Safari - A South African Adventure,34257135,16621530,17635605,2005.csv,2005,48.5%,51.5%
1938,Bad News Bears,34252847,32868349,1384498,2005.csv,2005,96%,4%
1939,Victor Frankenstein,34227298,5775076,28452222,2015.csv,2015,16.9%,83.1%
1940,The House,34184504,25584504,8600000,2017.csv,2017,74.8%,25.2%
1941,Cirque du Soleil: Worlds Away,34153101,12512862,21640239,2012.csv,2012,36.6%,63.4%
1942,Bad Guys: The Movie,34024386,166972,33857414,2019.csv,2019,0.5%,99.5%
1943,Darkness,33988736,22163442,11825294,2002.csv,2002,65.2%,34.8%
1944,Dungeons & Dragons,33978694,15391970,18586724,2000.csv,2000,45.3%,54.7%
1945,The Fighting Temptations,33972062,30250745,3721317,2003.csv,2003,89%,11%
1946,The Witness,33963557,418063,33545494,2015.csv,2015,1.2%,98.8%
1947,Hotel Rwanda,33882243,23530892,10351351,2004.csv,2004,69.4%,30.6%
1948,The Good Liar,33856058,17156058,16700000,2019.csv,2019,50.7%,49.3%
1949,Jay and Silent Bob Strike Back,33788161,30085147,3703014,2001.csv,2001,89%,11%
1950,The Art of Racing in the Rain,33766787,26395642,7371145,2019.csv,2019,78.2%,21.8%
1951,I Want to Eat Your Pancreas,33748006,277019,33470987,2017.csv,2017,0.8%,99.2%
1952,Nobody's Fool,33705333,31713110,1992223,2018.csv,2018,94.1%,5.9%
1953,The Skin I Live In,33678406,3185812,30492594,2011.csv,2011,9.5%,90.5%
1954,Y Tu Mamá También,33616692,13839658,19777034,2001.csv,2001,41.2%,58.8%
1955,Because of Winn-Dixie,33589427,32647042,942385,2005.csv,2005,97.2%,2.8%
1956,Friday After Next,33526835,33253609,273226,2002.csv,2002,99.2%,0.8%
1957,Red Planet,33463969,17480890,15983079,2000.csv,2000,52.2%,47.8%
1958,2016: Obama's America,33449086,33449086,0,2012.csv,2012,100%,-
1959,Get on Up,33448971,30703100,2745871,2014.csv,2014,91.8%,8.2%
1960,Wonder Boys,33426588,19393557,14033031,2000.csv,2000,58%,42%
1961,The Perks of Being a Wallflower,33384127,17742948,15641179,2012.csv,2012,53.1%,46.9%
1962,The Cave,33296457,15007991,18288466,2005.csv,2005,45.1%,54.9%
1963,Perfect Strangers,33262366,1014507,32247859,2017.csv,2017,3.1%,96.9%
1964,Confessions of a Teenage Drama Queen,33251890,29331068,3920822,2004.csv,2004,88.2%,11.8%
1965,Project Almanac,33213241,22348241,10865000,2015.csv,2015,67.3%,32.7%
1966,Bharat,33185983,2971549,30214434,2019.csv,2019,9%,91%
1967,Baaghi 2,33139063,1319579,31819484,2018.csv,2018,4%,96%
1968,The Crocodile Hunter: Collision Course,33082548,28442574,4639974,2002.csv,2002,86%,14%
1969,Girl with a Pearl Earring,33030115,11670971,21359144,2003.csv,2003,35.3%,64.7%
1970,Confessions of a Dangerous Mind,33013805,16007718,17006087,2002.csv,2002,48.5%,51.5%
1971,Lockout,32948113,14326864,18621249,2012.csv,2012,43.5%,56.5%
1972,Inside Llewyn Davis,32935319,13235319,19700000,2013.csv,2013,40.2%,59.8%
1973,Sleepless,32917353,20783704,12133649,2017.csv,2017,63.1%,36.9%
1974,Brightburn,32893421,17300439,15592982,2019.csv,2019,52.6%,47.4%
1975,Adaptation.,32801173,22498520,10302653,2002.csv,2002,68.6%,31.4%
1976,Katy Perry: Part of Me,32726956,25326071,7400885,2012.csv,2012,77.4%,22.6%
1977,Leap Year,32686500,25918920,6767580,2010.csv,2010,79.3%,20.7%
1978,Mud,32613173,21590086,11023087,2013.csv,2013,66.2%,33.8%
1979,Cry Wolf,32586408,10047674,22538734,2005.csv,2005,30.8%,69.2%
1980,The Musketeer,32533802,27073640,5460162,2001.csv,2001,83.2%,16.8%
1981,The Hurricane Heist,32517248,6115825,26401423,2018.csv,2018,18.8%,81.2%
1982,UglyDolls,32450241,20150241,12300000,2019.csv,2019,62.1%,37.9%
1983,Movie 43,32438988,8840453,23598535,2012.csv,2012,27.3%,72.7%
1984,Stuber,32390945,22370452,10020493,2019.csv,2019,69.1%,30.9%
1985,Kevin Hart: Let Me Explain,32318051,32244051,74000,2013.csv,2013,99.8%,0.2%
1986,Potiche,32309881,1618844,30691037,2010.csv,2010,5%,95%
1987,Hart's War,32287044,19077641,13209403,2002.csv,2002,59.1%,40.9%
1988,Seven Psychopaths,32226382,15024049,17202333,2012.csv,2012,46.6%,53.4%
1989,Reindeer Games,32168970,23368995,8799975,2000.csv,2000,72.6%,27.4%
1990,The Kid Who Would Be King,32140970,16790790,15350180,2019.csv,2019,52.2%,47.8%
1991,You Again,32054369,25702053,6352316,2010.csv,2010,80.2%,19.8%
1992,Dilwale,31994323,4871263,27123060,2015.csv,2015,15.2%,84.8%
1993,Suffragette,31972096,4702420,27269676,2015.csv,2015,14.7%,85.3%
1994,Bad Times at the El Royale,31882724,17839115,14043609,2018.csv,2018,56%,44%
1995,Self/less,31807156,12279691,19527465,2015.csv,2015,38.6%,61.4%
1996,Blood Work,31794718,26235081,5559637,2002.csv,2002,82.5%,17.5%
1997,Spring Breakers,31724284,14124284,17600000,2013.csv,2013,44.5%,55.5%
1998,Hunter Killer,31672678,15767460,15905218,2018.csv,2018,49.8%,50.2%
1999,Rent,31670620,29077547,2593073,2005.csv,2005,91.8%,8.2%
2000,New World,31670607,457806,31212801,2013.csv,2013,1.4%,98.6%
2001,Ae Dil Hai Mushkil,31668920,4264983,27403937,2016.csv,2016,13.5%,86.5%
2002,Super Troopers 2,31626386,30617396,1008990,2018.csv,2018,96.8%,3.2%
2003,Double Take,31603059,29831583,1771476,2001.csv,2001,94.4%,5.6%
2004,The New World 2005 Re-release,31510855,12712093,18798762,2005.csv,2005,40.3%,59.7%
2005,The Thing,31505287,16928670,14576617,2011.csv,2011,53.7%,46.3%
2006,I Don't Know How She Does It,31410151,9662284,21747867,2011.csv,2011,30.8%,69.2%
2007,Lost Souls,31355910,16815253,14540657,2000.csv,2000,53.6%,46.4%
2008,Anna,31329947,7743794,23586153,2019.csv,2019,24.7%,75.3%
2009,Johnson Family Vacation,31326183,31203964,122219,2004.csv,2004,99.6%,0.4%
2010,What's in a Name?,31303580,8111,31295469,2012.csv,2012,<0.1%,100%
2011,How High,31283740,31178740,105000,2001.csv,2001,99.7%,0.3%
2012,Tazza: The Hidden Card,31278476,251555,31026921,2014.csv,2014,0.8%,99.2%
2013,Saving Mr. Wu,31222161,92696,31129465,2015.csv,2015,0.3%,99.7%
2014,The New Guy,31167388,29760152,1407236,2002.csv,2002,95.5%,4.5%
2015,Joyful Noise,31158113,30932113,226000,2012.csv,2012,99.3%,0.7%
2016,Premium Rush,31083599,20275446,10808153,2012.csv,2012,65.2%,34.8%
2017,The Strangers: Prey at Night,31039126,24586708,6452418,2018.csv,2018,79.2%,20.8%
2018,The Wild Goose Lake,31037956,12573,31025383,2019.csv,2019,<0.1%,100%
2019,Beauty and the Beast 2000 IMAX Release,31033346,25487190,5546156,2001.csv,2001,82.1%,17.9%
2020,This Is Not What I Expected,30996615,337670,30658945,2017.csv,2017,1.1%,98.9%
2021,Joe Dirt,30987695,27087695,3900000,2001.csv,2001,87.4%,12.6%
2022,Playing for Keeps,30962335,13103272,17859063,2012.csv,2012,42.3%,57.7%
2023,Billy Lynn's Long Halftime Walk,30930984,1738477,29192507,2016.csv,2016,5.6%,94.4%
2024,The Promise,30925693,669625,30256068,2005.csv,2005,2.2%,97.8%
2025,Hearts in Atlantis,30919415,24185781,6733634,2001.csv,2001,78.2%,21.8%
2026,African Cats,30857747,15428747,15429000,2011.csv,2011,50%,50%
2027,Attack on Titan,30810658,449523,30361135,2015.csv,2015,1.5%,98.5%
2028,Winter's Tale,30800231,12600231,18200000,2014.csv,2014,40.9%,59.1%
2029,Monsoon Wedding,30787356,13885966,16901390,2001.csv,2001,45.1%,54.9%
2030,Wolf Creek,30762648,16188180,14574468,2005.csv,2005,52.6%,47.4%
2031,Norm of the North,30734502,17062499,13672003,2016.csv,2016,55.5%,44.5%
2032,Carnage,30722632,2547047,28175585,2011.csv,2011,8.3%,91.7%
2033,A Man Called Ove,30691696,3479315,27212381,2015.csv,2015,11.3%,88.7%
2034,A Wedding Invitation,30665036,14350,30650686,2013.csv,2013,<0.1%,100%
2035,When the Bough Breaks,30658387,29747603,910784,2016.csv,2016,97%,3%
2036,Wild Tales,30642704,3106530,27536174,2014.csv,2014,10.1%,89.9%
2037,City of God,30641770,7564459,23077311,2002.csv,2002,24.7%,75.3%
2038,Cabin Fever,30553394,21158188,9395206,2003.csv,2003,69.2%,30.8%
2039,Two for the Money,30526509,22991379,7535130,2005.csv,2005,75.3%,24.7%
2040,A Dangerous Method,30519436,5704709,24814727,2011.csv,2011,18.7%,81.3%
2041,What's Your Number?,30426096,14011084,16415012,2011.csv,2011,46%,54%
2042,The Girl Next Door,30381722,14589444,15792278,2004.csv,2004,48%,52%
2043,Nocturnal Animals,30311857,10663357,19648500,2016.csv,2016,35.2%,64.8%
2044,Far from the Madding Crowd,30229977,12236500,17993477,2015.csv,2015,40.5%,59.5%
2045,A Silent Voice: The Movie,30156463,310407,29846056,2016.csv,2016,1%,99%
2046,When the Game Stands Tall,30138754,30127963,10791,2014.csv,2014,100%,<0.1%
2047,The Rum Diary,30134958,13109815,17025143,2011.csv,2011,43.5%,56.5%
2048,Godsend,30120671,14379751,15740920,2004.csv,2004,47.7%,52.3%
2049,Shaun of the Dead,30076102,13542874,16533228,2004.csv,2004,45%,55%
2050,Laws of Attraction,30031874,17871255,12160619,2003.csv,2003,59.5%,40.5%
2051,Solaris,30002758,14973382,15029376,2002.csv,2002,49.9%,50.1%
2052,Reset 2017 Re-release,29945245,108970,29836275,2017.csv,2017,0.4%,99.6%
2053,Small Time Crooks,29934477,17266359,12668118,2000.csv,2000,57.7%,42.3%
2054,Keeping Up with the Joneses,29918745,14904426,15014319,2016.csv,2016,49.8%,50.2%
2055,The Four Feathers,29882645,18306166,11576479,2002.csv,2002,61.3%,38.7%
2056,The Bye Bye Man,29874280,22395806,7478474,2017.csv,2017,75%,25%
2057,Draft Day,29824199,28842237,981962,2014.csv,2014,96.7%,3.3%
2058,The Disaster Artist,29820616,21120616,8700000,2017.csv,2017,70.8%,29.2%
2059,Like a Boss,29753143,22169514,7583629,2020.csv,2020,74.5%,25.5%
2060,Bloodshot,29749454,10021787,19727667,2020.csv,2020,33.7%,66.3%
2061,Battlefield Earth,29725663,21471685,8253978,2000.csv,2000,72.2%,27.8%
2062,The Swindlers,29721916,241916,29480000,2017.csv,2017,0.8%,99.2%
2063,Angel Eyes,29715606,24174218,5541388,2001.csv,2001,81.4%,18.6%
2064,The Raven,29699345,16008272,13691073,2012.csv,2012,53.9%,46.1%
2065,Masterminds,29674699,17368022,12306677,2016.csv,2016,58.5%,41.5%
2066,Amour,29652180,6739492,22912688,2012.csv,2012,22.7%,77.3%
2067,Cursed,29621722,19297522,10324200,2005.csv,2005,65.1%,34.9%
2068,The Pledge,29419291,19733089,9686202,2001.csv,2001,67.1%,32.9%
2069,City by the Sea,29414087,22449000,6965087,2002.csv,2002,76.3%,23.7%
2070,Luther,29413900,5791328,23622572,2003.csv,2003,19.7%,80.3%
2071,The Losers,29397654,23591432,5806222,2010.csv,2010,80.2%,19.8%
2072,Bugs!,29388999,19063544,10325455,2003.csv,2003,64.9%,35.1%
2073,Baby Boy,29381649,28734552,647097,2001.csv,2001,97.8%,2.2%
2074,Nurse Betty,29360400,25170054,4190346,2000.csv,2000,85.7%,14.3%
2075,Mr. Holmes,29355203,17737646,11617557,2015.csv,2015,60.4%,39.6%
2076,Rowdy Rathore,29342463,777373,28565090,2012.csv,2012,2.6%,97.4%
2077,Sword Art Online The Movie: Ordinal Scale,29322339,1522976,27799363,2017.csv,2017,5.2%,94.8%
2078,Free Solo,29318861,17541090,11777771,2018.csv,2018,59.8%,40.2%
2079,Big Eyes,29253166,14482031,14771135,2014.csv,2014,49.5%,50.5%
2080,Yu-Gi-Oh!: The Movie - Pyramid of Light,29144802,19765868,9378934,2004.csv,2004,67.8%,32.2%
2081,Special ID,29139936,12666,29127270,2013.csv,2013,<0.1%,100%
2082,Cold Creek Manor,29119434,21386011,7733423,2003.csv,2003,73.4%,26.6%
2083,Sacrifice,29093560,29792,29063768,2010.csv,2010,0.1%,99.9%
2084,Pad Man,29045020,1670192,27374828,2018.csv,2018,5.8%,94.2%
2085,Far from Heaven,29027914,15901849,13126065,2002.csv,2002,54.8%,45.2%
2086,M.S. Dhoni: The Untold Story,28903047,1801550,27101497,2016.csv,2016,6.2%,93.8%
2087,Agent Cody Banks 2: Destination London,28818995,23630159,5188836,2004.csv,2004,82%,18%
2088,Boiler Room,28780255,16970581,11809674,2000.csv,2000,59%,41%
2089,Bol Bachchan,28775262,1216258,27559004,2012.csv,2012,4.2%,95.8%
2090,Twins 2,28733523,1431255,27302268,2017.csv,2017,5%,95%
2091,The Suspect,28674130,218693,28455437,2013.csv,2013,0.8%,99.2%
2092,Wrong Turn,28650575,15418790,13231785,2003.csv,2003,53.8%,46.2%
2093,The Fortress,28645448,252895,28392553,2017.csv,2017,0.9%,99.1%
2094,Love & Mercy,28641776,12551031,16090745,2015.csv,2015,43.8%,56.2%
2095,Heist,28510652,23510841,4999811,2001.csv,2001,82.5%,17.5%
2096,I Give It a Year,28328531,34657,28293874,2013.csv,2013,0.1%,99.9%
2097,Brown Sugar,28316451,27363891,952560,2002.csv,2002,96.6%,3.4%
2098,Thunderbirds,28283637,6880917,21402720,2004.csv,2004,24.3%,75.7%
2099,The Master,28258060,16377274,11880786,2012.csv,2012,58%,42%
2100,Fan,28240000,2300000,25940000,2016.csv,2016,8.1%,91.9%
2101,The Upside of Anger,28237488,18761993,9475495,2005.csv,2005,66.4%,33.6%
2102,L'auberge espagnole,28193749,1067438,27126311,2002.csv,2002,3.8%,96.2%
2103,Gully Boy,28141995,5566534,22575461,2019.csv,2019,19.8%,80.2%
2104,Pokemon 4Ever: Celebi - Voice of the Forest,28023563,1727447,26296116,2002.csv,2002,6.2%,93.8%
2105,Your Highness,28013733,21596445,6417288,2011.csv,2011,77.1%,22.9%
2106,The Tailor of Panama,28008462,13729742,14278720,2001.csv,2001,49%,51%
2107,Mandela: Long Walk to Freedom,27985788,8323085,19662703,2013.csv,2013,29.7%,70.3%
2108,The Brothers Grimsby,27979040,6874837,21104203,2016.csv,2016,24.6%,75.4%
2109,The 33,27972023,12227722,15744301,2015.csv,2015,43.7%,56.3%
2110,The Little Vampire,27965865,13572400,14393465,2000.csv,2000,48.5%,51.5%
2111,The Brothers,27958191,27457409,500782,2001.csv,2001,98.2%,1.8%
2112,The Divine Move,27926871,136707,27790164,2014.csv,2014,0.5%,99.5%
2113,Monster Family,27890108,127259,27762849,2017.csv,2017,0.5%,99.5%
2114,Mrs Henderson Presents,27876417,11036366,16840051,2005.csv,2005,39.6%,60.4%
2115,The Beguiled,27869129,10709995,17159134,2017.csv,2017,38.4%,61.6%
2116,Dark Skies,27858103,17418667,10439436,2013.csv,2013,62.5%,37.5%
2117,Love & Basketball,27728118,27459615,268503,2000.csv,2000,99%,1%
2118,Ruby & Quentin,27720972,312824,27408148,2003.csv,2003,1.1%,98.9%
2119,Default,27709716,203775,27505941,2018.csv,2018,0.7%,99.3%
2120,Dirty Dancing: Havana Nights,27685016,14161590,13523426,2004.csv,2004,51.2%,48.8%
2121,Nebraska,27682872,17654912,10027960,2013.csv,2013,63.8%,36.2%
2122,The Quiet American,27674124,12988801,14685323,2002.csv,2002,46.9%,53.1%
2123,Ice Princess,27645491,24402491,3243000,2005.csv,2005,88.3%,11.7%
2124,The Last Castle,27642707,18244060,9398647,2001.csv,2001,66%,34%
2125,Goal! The Dream Begins,27610873,4283255,23327618,2005.csv,2005,15.5%,84.5%
2126,One Cut of the Dead,27590180,52406,27537774,2018.csv,2018,0.2%,99.8%
2127,Cirque du Soleil: Journey of Man,27538359,15627434,11910925,2000.csv,2000,56.7%,43.3%
2128,The Women on the 6th Floor,27533970,719823,26814147,2011.csv,2011,2.6%,97.4%
2129,Mirai,27526961,812794,26714167,2018.csv,2018,3%,97%
2130,The Happytime Murders,27506452,20706452,6800000,2018.csv,2018,75.3%,24.7%
2131,The Incredible Burt Wonderstone,27437881,22537881,4900000,2013.csv,2013,82.1%,17.9%
2132,Left Behind,27405896,14019924,13385972,2014.csv,2014,51.2%,48.8%
2133,Irrational Man,27391084,4030360,23360724,2015.csv,2015,14.7%,85.3%
2134,Legend of the Fist: The Return of Chen Zhen,27390678,50433,27340245,2010.csv,2010,0.2%,99.8%
2135,Ella Enchanted,27388767,22918387,4470380,2004.csv,2004,83.7%,16.3%
2136,Detective K: Secret of the Lost Island,27387870,185367,27202503,2015.csv,2015,0.7%,99.3%
2137,Midnight Sun,27365467,9561064,17804403,2018.csv,2018,34.9%,65.1%
2138,Ramona and Beezus,27293743,26167002,1126741,2010.csv,2010,95.9%,4.1%
2139,American Ultra,27262374,14440985,12821389,2015.csv,2015,53%,47%
2140,Khumba,27187375,1029,27186346,2013.csv,2013,<0.1%,100%
2141,The Protector,27165581,12044087,15121494,2005.csv,2005,44.3%,55.7%
2142,Splice 2010 Re-release,27127620,17010170,10117450,2010.csv,2010,62.7%,37.3%
2143,Let Me In,27093592,12134935,14958657,2010.csv,2010,44.8%,55.2%
2144,My Neighbor Totoro 2018 Re-release,27083857,1144649,25939208,2018.csv,2018,4.2%,95.8%
2145,Hitchcock,27039669,6008677,21030992,2012.csv,2012,22.2%,77.8%
2146,The Crime of Padre Amaro,26996738,5717044,21279694,2002.csv,2002,21.2%,78.8%
2147,Total Dhamaal,26911995,2167632,24744363,2019.csv,2019,8.1%,91.9%
2148,You're Next,26895481,18494006,8401475,2013.csv,2013,68.8%,31.2%
2149,The In-Laws,26891849,20453431,6438418,2003.csv,2003,76.1%,23.9%
2150,CHIPS,26800152,18600152,8200000,2017.csv,2017,69.4%,30.6%
2151,Doogal,26711924,7438000,19273924,2005.csv,2005,27.8%,72.2%
2152,A Cure for Wellness,26620002,8106986,18513016,2017.csv,2017,30.5%,69.5%
2153,No Manches Frida 2,26493648,9270920,17222728,2019.csv,2019,35%,65%
2154,A Hard Day,26488847,19004,26469843,2014.csv,2014,<0.1%,99.9%
2155,The Way Way Back,26474920,21506546,4968374,2013.csv,2013,81.2%,18.8%
2156,Center Stage,26385941,17200925,9185016,2000.csv,2000,65.2%,34.8%
2157,Only the Brave,26351322,18343983,8007339,2017.csv,2017,69.6%,30.4%
2158,Saving Grace,26330482,12178602,14151880,2000.csv,2000,46.3%,53.7%
2159,All About the Benjamins,26306533,25916319,390214,2002.csv,2002,98.5%,1.5%
2160,Aloha,26250020,21067116,5182904,2015.csv,2015,80.3%,19.7%
2161,Missing Link,26249469,16649539,9599930,2019.csv,2019,63.4%,36.6%
2162,Apollo 18,26236153,17687709,8548444,2011.csv,2011,67.4%,32.6%
2163,Typhoon,26179656,139059,26040597,2005.csv,2005,0.5%,99.5%
2164,The Whole Ten Yards,26170671,16328471,9842200,2004.csv,2004,62.4%,37.6%
2165,The Zookeeper's Wife,26152835,17571660,8581175,2017.csv,2017,67.2%,32.8%
2166,Badrinath Ki Dulhania,26134309,1993259,24141050,2017.csv,2017,7.6%,92.4%
2167,Top Five,26117471,25317471,800000,2014.csv,2014,96.9%,3.1%
2168,Saving Silverman,26086706,19402030,6684676,2001.csv,2001,74.4%,25.6%
2169,Hichki,26055222,330279,25724943,2018.csv,2018,1.3%,98.7%
2170,Iceman,26033917,7679,26026238,2014.csv,2014,<0.1%,100%
2171,The Light Between Oceans,25975621,12545979,13429642,2016.csv,2016,48.3%,51.7%
2172,White Boy Rick,25957482,24011188,1946294,2018.csv,2018,92.5%,7.5%
2173,"Paul, Apostle of Christ",25915966,17560475,8355491,2018.csv,2018,67.8%,32.2%
2174,Huevos: Little Rooster's Egg-cellent Adventure,25892561,9080818,16811743,2015.csv,2015,35.1%,64.9%
2175,Rollerball,25852764,18990798,6861966,2002.csv,2002,73.5%,26.5%
2176,Boys and Girls,25850615,21799652,4050963,2000.csv,2000,84.3%,15.7%
2177,The Alamo,25819961,22414961,3405000,2004.csv,2004,86.8%,13.2%
2178,Rust and Bone,25807712,2062027,23745685,2012.csv,2012,8%,92%
2179,Our Idiot Brother,25804448,24816118,988330,2011.csv,2011,96.2%,3.8%
2180,Fair Game,25798915,9540691,16258224,2010.csv,2010,37%,63%
2181,"The Gangster, the Cop, the Devil",25775371,216494,25558877,2019.csv,2019,0.8%,99.2%
2182,A Beautiful Planet,25730120,15650615,10079505,2016.csv,2016,60.8%,39.2%
2183,Fireworks,25672406,525280,25147126,2017.csv,2017,2%,98%
2184,Jonah: A VeggieTales Movie,25615231,25581229,34002,2002.csv,2002,99.9%,0.1%
2185,Father Figures,25601244,17501244,8100000,2017.csv,2017,68.4%,31.6%
2186,"Love, Rosie",25574387,20431,25553956,2014.csv,2014,<0.1%,99.9%
2187,Mr. Donkey,25537759,356255,25181504,2016.csv,2016,1.4%,98.6%
2188,The Tiger and the Snow,25460023,10167,25449856,2005.csv,2005,<0.1%,100%
2189,In America,25382911,15539656,9843255,2003.csv,2003,61.2%,38.8%
2190,Keys To The Heart,25375866,75134,25300732,2018.csv,2018,0.3%,99.7%
2191,A Haunted House 2,25358716,17329486,8029230,2014.csv,2014,68.3%,31.7%
2192,And So It Goes,25312387,15160801,10151586,2014.csv,2014,59.9%,40.1%
2193,Enough Said,25288872,17550872,7738000,2013.csv,2013,69.4%,30.6%
2194,Corky Romano,25272752,23980304,1292448,2001.csv,2001,94.9%,5.1%
2195,North Country,25211175,18337722,6873453,2005.csv,2005,72.7%,27.3%
2196,Emma.,25155355,10055355,15100000,2020.csv,2020,40%,60%
2197,Biutiful,25147786,5101237,20046549,2010.csv,2010,20.3%,79.7%
2198,On the Other Side of the Tracks,25109572,9572,25100000,2012.csv,2012,<0.1%,100%
2199,Born in China,25081168,13873211,11207957,2016.csv,2016,55.3%,44.7%
2200,Race,25070261,19206207,5864054,2016.csv,2016,76.6%,23.4%
2201,The Last Exorcism Part II,25051865,15179302,9872563,2013.csv,2013,60.6%,39.4%
2202,Free State of Jones,25035950,20810036,4225914,2016.csv,2016,83.1%,16.9%
2203,Whiskey Tango Foxtrot,24972139,23083334,1888805,2016.csv,2016,92.4%,7.6%
2204,The Way Home,24952738,445367,24507371,2002.csv,2002,1.8%,98.2%
2205,Booksmart,24863452,22680962,2182490,2019.csv,2019,91.2%,8.8%
2206,Seed of Chucky,24829644,17083732,7745912,2004.csv,2004,68.8%,31.2%
2207,Wild City,24817852,34866,24782986,2015.csv,2015,0.1%,99.9%
2208,Sarah's Key,24792815,7693187,17099628,2010.csv,2010,31%,69%
2209,Lottery Ticket,24719879,24719879,0,2010.csv,2010,100%,-
2210,Big Miracle,24719215,20157300,4561915,2012.csv,2012,81.5%,18.5%
2211,Bride & Prejudice,24716440,6605592,18110848,2004.csv,2004,26.7%,73.3%
2212,Super 30,24701637,2269878,22431759,2019.csv,2019,9.2%,90.8%
2213,The Shipping News,24690441,11434216,13256225,2001.csv,2001,46.3%,53.7%
2214,Drug War,24676341,128195,24548146,2013.csv,2013,0.5%,99.5%
2215,Punch-Drunk Love,24665649,17844216,6821433,2002.csv,2002,72.3%,27.7%
2216,The Death of Stalin,24646055,8047856,16598199,2017.csv,2017,32.7%,67.3%
2217,The Snow Queen 3: Fire and Ice,24644317,0,24644317,2016.csv,2016,-,100%
2218,Sparkle,24637800,24397469,240331,2012.csv,2012,99%,1%
2219,The Players,24629152,10854,24618298,2012.csv,2012,<0.1%,100%
2220,Capture the Flag,24604331,6690,24597641,2015.csv,2015,<0.1%,100%
2221,Joe Somebody,24516772,22771646,1745126,2001.csv,2001,92.9%,7.1%
2222,God's Not Dead 2,24487848,20774575,3713273,2016.csv,2016,84.8%,15.2%
2223,Stan & Ollie,24420923,5470235,18950688,2018.csv,2018,22.4%,77.6%
2224,Down to You,24419914,20069008,4350906,2000.csv,2000,82.2%,17.8%
2225,The Tale of The Princess Kaguya,24366656,703232,23663424,2013.csv,2013,2.9%,97.1%
2226,The Next Best Thing,24362772,14990582,9372190,2000.csv,2000,61.5%,38.5%
2227,Nowhere in Africa,24322180,6180200,18141980,2001.csv,2001,25.4%,74.6%
2228,The Great Beauty,24271739,2852400,21419339,2013.csv,2013,11.8%,88.2%
2229,Jackie,24270399,13960394,10310005,2016.csv,2016,57.5%,42.5%
2230,Trance,24261569,2328743,21932826,2013.csv,2013,9.6%,90.4%
2231,The Accidental Detective 2: In Action,24243825,179045,24064780,2018.csv,2018,0.7%,99.3%
2232,Jolly LLB 2,24214186,1654254,22559932,2017.csv,2017,6.8%,93.2%
2233,The Gunman,24177137,10664749,13512388,2015.csv,2015,44.1%,55.9%
2234,The Railway Man,24174885,4438438,19736447,2013.csv,2013,18.4%,81.6%
2235,The Way Back,24172201,2701859,21470342,2010.csv,2010,11.2%,88.8%
2236,The Guru,24128852,3095506,21033346,2002.csv,2002,12.8%,87.2%
2237,The Founder,24121245,12786053,11335192,2016.csv,2016,53%,47%
2238,Bad Santa 2,24079268,17782178,6297090,2016.csv,2016,73.8%,26.2%
2239,Kung Fu Jungle,24070765,129784,23940981,2014.csv,2014,0.5%,99.5%
2240,I Can Speak,24024444,63239,23961205,2017.csv,2017,0.3%,99.7%
2241,Harold & Kumar Go to White Castle,23936908,18250550,5686358,2004.csv,2004,76.2%,23.8%
2242,25th Hour,23928503,13084595,10843908,2002.csv,2002,54.7%,45.3%
2243,Birth,23925492,5095038,18830454,2004.csv,2004,21.3%,78.7%
2244,Life as a House,23903791,15667270,8236521,2001.csv,2001,65.5%,34.5%
2245,Spirits' Homecoming,23857217,125616,23731601,2016.csv,2016,0.5%,99.5%
2246,Silence,23834809,7100177,16734632,2016.csv,2016,29.8%,70.2%
2247,Lady Vengeance,23834149,211667,23622482,2005.csv,2005,0.9%,99.1%
2248,Eight Crazy Nights,23833131,23586598,246533,2002.csv,2002,99%,1%
2249,Wanderlust,23812816,17450535,6362281,2012.csv,2012,73.3%,26.7%
2250,Dickie Roberts: Former Child Star,23769505,22738671,1030834,2003.csv,2003,95.7%,4.3%
2251,The Dressmaker,23762417,2022115,21740302,2015.csv,2015,8.5%,91.5%
2252,Pokémon the Movie: The Power of Us,23740788,789170,22951618,2018.csv,2018,3.3%,96.7%
2253,Russian Dolls,23727301,326095,23401206,2005.csv,2005,1.4%,98.6%
2254,In the Cut,23726793,4750602,18976191,2003.csv,2003,20%,80%
2255,Amy,23706049,8413144,15292905,2015.csv,2015,35.5%,64.5%
2256,To the Arctic 3D,23695388,14560838,9134550,2012.csv,2012,61.5%,38.5%
2257,The Glass House,23619609,18150259,5469350,2001.csv,2001,76.8%,23.2%
2258,Kevin Hart: What Now?,23591043,23591043,0,2016.csv,2016,100%,-
2259,Hustle & Flow,23563727,22202809,1360918,2005.csv,2005,94.2%,5.8%
2260,No manches Frida,23540937,11528613,12012324,2016.csv,2016,49%,51%
2261,Biker Boyz,23510621,22076772,1433849,2003.csv,2003,93.9%,6.1%
2262,Wish Upon,23468586,14301505,9167081,2017.csv,2017,60.9%,39.1%
2263,Youth,23459358,2703296,20756062,2015.csv,2015,11.5%,88.5%
2264,Tomcats,23430766,13558739,9872027,2001.csv,2001,57.9%,42.1%
2265,Kingdom Come,23396049,23249649,146400,2001.csv,2001,99.4%,0.6%
2266,Antwone Fisher,23367586,21078145,2289441,2002.csv,2002,90.2%,9.8%
2267,Detroit,23355100,16790139,6564961,2017.csv,2017,71.9%,28.1%
2268,Middle School: The Worst Years of My Life,23316139,20007149,3308990,2016.csv,2016,85.8%,14.2%
2269,Warrior,23308615,13657115,9651500,2011.csv,2011,58.6%,41.4%
2270,Super Troopers,23182223,18492362,4689861,2002.csv,2002,79.8%,20.2%
2271,Triple 9,23177948,12639297,10538651,2016.csv,2016,54.5%,45.5%
2272,Hoodwinked! 2011 Re-release,23167844,10143779,13024065,2011.csv,2011,43.8%,56.2%
2273,Rock Dog,23157646,9420546,13737100,2016.csv,2016,40.7%,59.3%
2274,The Choice,23064015,18730891,4333124,2016.csv,2016,81.2%,18.8%
2275,Portrait of a Lady on Fire,23038758,3759854,19278904,2019.csv,2019,16.3%,83.7%
2276,Confidence,23014206,12251640,10762566,2003.csv,2003,53.2%,46.8%
2277,Padmaavat,22991060,11846060,11145000,2018.csv,2018,51.5%,48.5%
2278,The Peanut Butter Falcon,22986166,20457151,2529015,2019.csv,2019,89%,11%
2279,The Human Stain,22954068,5381908,17572160,2003.csv,2003,23.4%,76.6%
2280,Domino,22944502,10169202,12775300,2005.csv,2005,44.3%,55.7%
2281,Young Adult,22939027,16311571,6627456,2011.csv,2011,71.1%,28.9%
2282,A Separation,22926076,7099055,15827021,2011.csv,2011,31%,69%
2283,Baggage Claim,22871096,21569509,1301587,2013.csv,2013,94.3%,5.7%
2284,Dr. T & the Women,22844291,13113041,9731250,2000.csv,2000,57.4%,42.6%
2285,Kon-Tiki,22842887,1517410,21325477,2012.csv,2012,6.6%,93.4%
2286,Won't You Be My Neighbor?,22842400,22835787,6613,2018.csv,2018,100%,<0.1%
2287,Sweet Sixteen,22819702,34327,22785375,2016.csv,2016,0.2%,99.8%
2288,Captain Fantastic,22787526,5879835,16907691,2016.csv,2016,25.8%,74.2%
2289,Extraordinary Mission,22757764,54174,22703590,2017.csv,2017,0.2%,99.8%
2290,Black and Blue,22741061,22055313,685748,2019.csv,2019,97%,3%
2291,Fading Gigolo,22706304,3769873,18936431,2014.csv,2014,16.6%,83.4%
2292,Live by Night,22678555,10378555,12300000,2016.csv,2016,45.8%,54.2%
2293,EuroTrip,22605153,17771387,4833766,2004.csv,2004,78.6%,21.4%
2294,Hunt for the Wilderpeople,22591592,5205468,17386124,2016.csv,2016,23%,77%
2295,Julieta,22468044,1490948,20977096,2016.csv,2016,6.6%,93.4%
2296,The Farewell,22459201,17695781,4763420,2019.csv,2019,78.8%,21.2%
2297,Swimming Pool,22441497,10130108,12311389,2003.csv,2003,45.1%,54.9%
2298,Two Can Play That Game,22391450,22235901,155549,2001.csv,2001,99.3%,0.7%
2299,Late Night,22386555,15499454,6887101,2019.csv,2019,69.2%,30.8%
2300,Mojin: The Worm Valley,22381583,101516,22280067,2018.csv,2018,0.5%,99.5%
2301,The Contender,22361811,17872723,4489088,2000.csv,2000,79.9%,20.1%
2302,Solace,22354572,0,22354572,2015.csv,2015,-,100%
2303,Twenty,22271862,136125,22135737,2015.csv,2015,0.6%,99.4%
2304,My Lucky Star,22259179,64432,22194747,2013.csv,2013,0.3%,99.7%
2305,NASCAR: The IMAX Experience,22248831,21583831,665000,2004.csv,2004,97%,3%
2306,Fifty Shades of Black,22227514,11686940,10540574,2015.csv,2015,52.6%,47.4%
2307,Upside Down,22187813,105095,22082718,2012.csv,2012,0.5%,99.5%
2308,Mr. Turner,22179785,3958500,18221285,2014.csv,2014,17.8%,82.2%
2309,Ghosts of the Abyss,22141539,17040871,5100668,2003.csv,2003,77%,23%
2310,Sabotage,22126842,10508518,11618324,2014.csv,2014,47.5%,52.5%
2311,The Glass Castle,22088533,17273059,4815474,2017.csv,2017,78.2%,21.8%
2312,Little Black Book,22035509,20698668,1336841,2004.csv,2004,93.9%,6.1%
2313,Big Brother,22029250,85624,21943626,2018.csv,2018,0.4%,99.6%
2314,Gretel & Hansel,21984429,15347654,6636775,2020.csv,2020,69.8%,30.2%
2315,Love Don't Cost a Thing,21964072,21924226,39846,2003.csv,2003,99.8%,0.2%
2316,Bullet to the Head,21947209,9489829,12457380,2013.csv,2013,43.2%,56.8%
2317,Leap! 2017 Re-release,21929861,21858070,71791,2017.csv,2017,99.7%,0.3%
2318,Mr 3000,21839377,21811187,28190,2004.csv,2004,99.9%,0.1%
2319,Black or White,21833967,21571189,262778,2015.csv,2015,98.8%,1.2%
2320,Master Z: The Ip Man Legacy,21832649,209454,21623195,2018.csv,2018,1%,99%
2321,The Barbarian Invasions 2003 Re-release,21815430,3435749,18379681,2003.csv,2003,15.7%,84.3%
2322,Welcome Back,21775694,1388365,20387329,2015.csv,2015,6.4%,93.6%
2323,Diana,21766271,335359,21430912,2013.csv,2013,1.5%,98.5%
2324,Legends of Oz: Dorothy's Return,21755418,8462347,13293071,2014.csv,2014,38.9%,61.1%
2325,Proud Mary,21753365,20877013,876352,2018.csv,2018,96%,4%
2326,22 Bullets,21695883,0,21695883,2010.csv,2010,-,100%
2327,White Oleander,21672284,16357770,5314514,2002.csv,2002,75.5%,24.5%
2328,Just Wright,21584424,21540363,44061,2010.csv,2010,99.8%,0.2%
2329,Man of the House,21577624,19699706,1877918,2005.csv,2005,91.3%,8.7%
2330,Wicker Park,21568818,13001257,8567561,2004.csv,2004,60.3%,39.7%
2331,It Follows,21528593,14674076,6854517,2015.csv,2015,68.2%,31.8%
2332,Win a Date with Tad Hamilton!,21513434,17071962,4441472,2004.csv,2004,79.4%,20.6%
2333,My Soul to Take,21500813,14744435,6756378,2010.csv,2010,68.6%,31.4%
2334,Winged Migration,21493351,924651,20568700,2001.csv,2001,4.3%,95.7%
2335,Dark Waters,21440704,11136084,10304620,2019.csv,2019,51.9%,48.1%
2336,The Merchant of Venice,21417725,3765585,17652140,2004.csv,2004,17.6%,82.4%
2337,Our Family Wedding,21409028,20255281,1153747,2010.csv,2010,94.6%,5.4%
2338,Love & Friendship,21401949,14016568,7385381,2016.csv,2016,65.5%,34.5%
2339,Shaft,21360215,21360215,0,2019.csv,2019,100%,-
2340,Bears,21316745,17780194,3536551,2014.csv,2014,83.4%,16.6%
2341,Hotel Mumbai,21314816,9651611,11663205,2019.csv,2019,45.3%,54.7%
2342,Love Live! The School Idol Movie,21292009,115840,21176169,2015.csv,2015,0.5%,99.5%
2343,New York Minute,21289826,14071441,7218385,2004.csv,2004,66.1%,33.9%
2344,Michael Jordan to the Max,21268532,18650521,2618011,2000.csv,2000,87.7%,12.3%
2345,I'm So Excited!,21245677,1368119,19877558,2013.csv,2013,6.4%,93.6%
2346,The Prison,21205329,207481,20997848,2017.csv,2017,1%,99%
2347,The Prodigy,21150265,14856291,6293974,2018.csv,2018,70.2%,29.8%
2348,Mindhunters,21148829,4480744,16668085,2004.csv,2004,21.2%,78.8%
2349,The Jacket,21126225,6303762,14822463,2005.csv,2005,29.8%,70.2%
2350,Beasts of the Southern Wild,21107746,12795746,8312000,2012.csv,2012,60.6%,39.4%
2351,Unplanned,21051915,19005109,2046806,2019.csv,2019,90.3%,9.7%
2352,Gonjiam: Haunted Asylum,21041950,115252,20926698,2018.csv,2018,0.5%,99.5%
2353,Yves Saint Laurent,21026290,723593,20302697,2014.csv,2014,3.4%,96.6%
2354,My Hero Academia: Two Heroes,21022724,5754556,15268168,2018.csv,2018,27.4%,72.6%
2355,The Infiltrator,21011110,15436808,5574302,2016.csv,2016,73.5%,26.5%
2356,Before Midnight,20994648,8114627,12880021,2013.csv,2013,38.7%,61.3%
2357,71: Into the Fire,20967660,176638,20791022,2010.csv,2010,0.8%,99.2%
2358,El Niño,20918976,1237,20917739,2014.csv,2014,<0.1%,100%
2359,Amores Perros,20908467,5408467,15500000,2001.csv,2001,25.9%,74.1%
2360,The Devil's Rejects,20901859,17044981,3856878,2005.csv,2005,81.5%,18.5%
2361,Pokémon Heroes,20867919,746381,20121538,2002.csv,2002,3.6%,96.4%
2362,A Thousand Words 2012 Re-release,20803842,18450127,2353715,2012.csv,2012,88.7%,11.3%
2363,Best in Show,20789556,18715392,2074164,2000.csv,2000,90%,10%
2364,SuperFly,20780685,20545116,235569,2018.csv,2018,98.9%,1.1%
2365,I Love You Phillip Morris 2010 Re-release,20722843,2037459,18685384,2010.csv,2010,9.8%,90.2%
2366,Keanu,20651333,20591853,59480,2016.csv,2016,99.7%,0.3%
2367,Super Size Me,20645757,11536423,9109334,2004.csv,2004,55.9%,44.1%
2368,The Front Line,20629645,11018,20618627,2011.csv,2011,<0.1%,99.9%
2369,If Beale Street Could Talk,20596567,14915773,5680794,2018.csv,2018,72.4%,27.6%
2370,The Best Offer,20596350,100035,20496315,2013.csv,2013,0.5%,99.5%
2371,Polisse,20590872,211440,20379432,2011.csv,2011,1%,99%
2372,The Man with the Iron Fists,20546518,15634090,4912428,2012.csv,2012,76.1%,23.9%
2373,Country Strong,20529194,20218921,310273,2010.csv,2010,98.5%,1.5%
2374,Cock and Bull,20490872,82778,20408094,2016.csv,2016,0.4%,99.6%
2375,The Sapphires,20423628,2450867,17972761,2012.csv,2012,12%,88%
2376,That Demon Within,20415934,172343,20243591,2014.csv,2014,0.8%,99.2%
2377,The Clan,20381995,201227,20180768,2015.csv,2015,1%,99%
2378,Ladies in Lavender,20377075,6765081,13611994,2004.csv,2004,33.2%,66.8%
2379,Burn the Stage: The Movie,20347513,4201819,16145694,2018.csv,2018,20.7%,79.3%
2380,Brahms: The Boy II,20311536,12611536,7700000,2020.csv,2020,62.1%,37.9%
2381,Cold War 2018 Re-release,20285066,4580048,15705018,2018.csv,2018,22.6%,77.4%
2382,Labor Day,20275812,13371528,6904284,2014.csv,2014,65.9%,34.1%
2383,Ong-Bak: The Thai Warrior,20235426,4563167,15672259,2003.csv,2003,22.6%,77.4%
2384,Singh Is Bliing,20224851,919095,19305756,2015.csv,2015,4.5%,95.5%
2385,Serving Sara,20146150,16930185,3215965,2002.csv,2002,84%,16%
2386,Melinda and Melinda,20129327,3826280,16303047,2004.csv,2004,19%,81%
2387,Mulholland Drive,20117339,7220243,12897096,2001.csv,2001,35.9%,64.1%
2388,I Heart Huckabees,20072172,12785432,7286740,2004.csv,2004,63.7%,36.3%
2389,The Bling Ring,20045576,5845732,14199844,2013.csv,2013,29.2%,70.8%
2390,Asterix and Obelix Meet Cleopatra 2002 Re-release,20015611,3115188,16900423,2002.csv,2002,15.6%,84.4%
2391,The Company You Keep,20014680,5133027,14881653,2012.csv,2012,25.6%,74.4%
2392,The Wife,19978189,9601092,10377097,2018.csv,2018,48.1%,51.9%
2393,Himalaya 2001 Re-release,19960881,2487878,17473003,2001.csv,2001,12.5%,87.5%
2394,Crazy/Beautiful,19937988,16937988,3000000,2001.csv,2001,85%,15%
2395,Ballistic: Ecks vs. Sever,19924033,14307963,5616070,2002.csv,2002,71.8%,28.2%
2396,Get Over It,19900366,11576464,8323902,2001.csv,2001,58.2%,41.8%
2397,The Rooftop,19833152,85755,19747397,2013.csv,2013,0.4%,99.6%
2398,Summer Catch,19772447,19753553,18894,2001.csv,2001,99.9%,<0.1%
2399,The Perfect Man,19770475,16535005,3235470,2005.csv,2005,83.6%,16.4%
2400,Gone,19767535,11682205,8085330,2012.csv,2012,59.1%,40.9%
2401,Thomas and the Magic Railroad,19748009,15933506,3814503,2000.csv,2000,80.7%,19.3%
2402,It Comes At Night,19735344,13985117,5750227,2017.csv,2017,70.9%,29.1%
2403,Another Year,19722766,3205706,16517060,2010.csv,2010,16.3%,83.7%
2404,Brothers,19694450,613775,19080675,2015.csv,2015,3.1%,96.9%
2405,Blackhat,19652057,8005980,11646077,2015.csv,2015,40.7%,59.3%
2406,Youth in Revolt,19651093,15281286,4369807,2010.csv,2010,77.8%,22.2%
2407,Shackleton's Antarctic Adventure,19613216,15553324,4059892,2001.csv,2001,79.3%,20.7%
2408,S1m0ne,19576023,9688676,9887347,2002.csv,2002,49.5%,50.5%
2409,The Guard,19561904,5360274,14201630,2011.csv,2011,27.4%,72.6%
2410,Puella Magi Madoka Magica the Movie Part III: Rebellion,19544634,375627,19169007,2013.csv,2013,1.9%,98.1%
2411,View from the Top,19526014,15614000,3912014,2003.csv,2003,80%,20%
2412,Margin Call,19504039,5354039,14150000,2011.csv,2011,27.5%,72.5%
2413,In This Corner of the World,19496308,172147,19324161,2016.csv,2016,0.9%,99.1%
2414,The Lion King 2002 IMAX Release,19486215,15686215,3800000,2002.csv,2002,80.5%,19.5%
2415,2046,19470239,1444588,18025651,2004.csv,2004,7.4%,92.6%
2416,Blue Is the Warmest Colour,19465835,2199787,17266048,2013.csv,2013,11.3%,88.7%
2417,Vanity Fair,19463185,16136476,3326709,2004.csv,2004,82.9%,17.1%
2418,Buried,19439764,1044143,18395621,2010.csv,2010,5.4%,94.6%
2419,Get Carter,19412993,14967182,4445811,2000.csv,2000,77.1%,22.9%
2420,The Edge of Seventeen,19370020,14431633,4938387,2016.csv,2016,74.5%,25.5%
2421,Tuck Everlasting,19344615,19161999,182616,2002.csv,2002,99.1%,0.9%
2422,Rock Star,19334145,17008282,2325863,2001.csv,2001,88%,12%
2423,Duplex,19322135,9692135,9630000,2003.csv,2003,50.2%,49.8%
2424,Deep Blue,19288261,132261,19156000,2003.csv,2003,0.7%,99.3%
2425,The Lost City of Z,19263938,8580410,10683528,2017.csv,2017,44.5%,55.5%
2426,O,19260537,16025437,3235100,2001.csv,2001,83.2%,16.8%
2427,Half Past Dead,19233280,15567860,3665420,2002.csv,2002,80.9%,19.1%
2428,Foxcatcher,19206513,12096300,7110213,2014.csv,2014,63%,37%
2429,Martin Lawrence Live: Runteldat,19184820,19184820,0,2002.csv,2002,100%,-
2430,Everybody Knows,19176163,2660165,16515998,2018.csv,2018,13.9%,86.1%
2431,My Annoying Brother,19162324,51996,19110328,2016.csv,2016,0.3%,99.7%
2432,They Shall Not Grow Old 2018 Re-release,19130011,17956913,1173098,2018.csv,2018,93.9%,6.1%
2433,Oolong Courtyard: KungFu School,19129015,37727,19091288,2018.csv,2018,0.2%,99.8%
2434,The Weather Man,19126398,12482775,6643623,2005.csv,2005,65.3%,34.7%
2435,Shame,19123767,3909002,15214765,2011.csv,2011,20.4%,79.6%
2436,Norwegian Wood,19115721,13000,19102721,2010.csv,2010,<0.1%,99.9%
2437,Always Miss You,19015465,91884,18923581,2019.csv,2019,0.5%,99.5%
2438,Memoir of a Murderer,19015346,91335,18924011,2017.csv,2017,0.5%,99.5%
2439,Headhunters,18962444,1200010,17762434,2011.csv,2011,6.3%,93.7%
2440,The Man Who Wasn't There,18916623,7504257,11412366,2001.csv,2001,39.7%,60.3%
2441,The Curse of the Jade Scorpion,18914307,7517191,11397116,2001.csv,2001,39.7%,60.3%
2442,Feardotcom,18902015,13258249,5643766,2002.csv,2002,70.1%,29.9%
2443,A Mighty Wind,18750246,17781006,969240,2003.csv,2003,94.8%,5.2%
2444,Look at Me,18729751,1737308,16992443,2004.csv,2004,9.3%,90.7%
2445,3000 Miles to Graceland,18720175,15749959,2970216,2001.csv,2001,84.1%,15.9%
2446,Pina,18705853,3524826,15181027,2011.csv,2011,18.8%,81.2%
2447,13 Assassins,18689058,802778,17886280,2010.csv,2010,4.3%,95.7%
2448,Glee: The 3D Concert Movie,18663238,11862398,6800840,2011.csv,2011,63.6%,36.4%
2449,The Drop,18658381,10724389,7933992,2014.csv,2014,57.5%,42.5%
2450,Greta,18653107,10532219,8120888,2019.csv,2019,56.5%,43.5%
2451,Peppa Celebrates Chinese New Year,18653040,131225,18521815,2019.csv,2019,0.7%,99.3%
2452,Waiting...,18637690,16124543,2513147,2005.csv,2005,86.5%,13.5%
2453,Admission,18637201,18007317,629884,2013.csv,2013,96.6%,3.4%
2454,Max Keeble's Big Move,18634654,17294293,1340361,2001.csv,2001,92.8%,7.2%
2455,An Unfinished Life,18618284,8586392,10031892,2005.csv,2005,46.1%,53.9%
2456,De-Lovely,18611951,13456633,5155318,2004.csv,2004,72.3%,27.7%
2457,Detective K: Secret of the Living Dead,18603476,104013,18499463,2018.csv,2018,0.6%,99.4%
2458,The Lighthouse,18601951,10867104,7734847,2019.csv,2019,58.4%,41.6%
2459,Battle of the Sexes,18598607,12638526,5960081,2017.csv,2017,68%,32%
2460,Empire,18591272,17600423,990849,2002.csv,2002,94.7%,5.3%
2461,Keeping Mum,18575768,1619466,16956302,2005.csv,2005,8.7%,91.3%
2462,Black Christmas,18529730,10429730,8100000,2019.csv,2019,56.3%,43.7%
2463,Airpocalypse,18491089,105678,18385411,2018.csv,2018,0.6%,99.4%
2464,My Baby's Daddy,18490423,17669317,821106,2004.csv,2004,95.6%,4.4%
2465,Motherless Brooklyn,18477736,9277736,9200000,2019.csv,2019,50.2%,49.8%
2466,The Turning,18474062,15472775,3001287,2020.csv,2020,83.8%,16.2%
2467,Repo Men,18409891,13794835,4615056,2010.csv,2010,74.9%,25.1%
2468,Loser,18404706,15618626,2786080,2000.csv,2000,84.9%,15.1%
2469,The Wasted Times,18345372,386540,17958832,2016.csv,2016,2.1%,97.9%
2470,Fabricated City,18307490,104874,18202616,2017.csv,2017,0.6%,99.4%
2471,Asura,18300843,175702,18125141,2016.csv,2016,1%,99%
2472,The World's Fastest Indian,18297690,5128124,13169566,2005.csv,2005,28%,72%
2473,Chappaquiddick,18263470,17395520,867950,2018.csv,2018,95.2%,4.8%
2474,Antitrust,18195610,11328094,6867516,2001.csv,2001,62.3%,37.7%
2475,My Boss's Daughter,18191005,15550605,2640400,2003.csv,2003,85.5%,14.5%
2476,The Case for Christ,18175663,14682684,3492979,2017.csv,2017,80.8%,19.2%
2477,Sorry to Bother You,18170707,17493096,677611,2018.csv,2018,96.3%,3.7%
2478,Hell Fest,18159691,11107431,7052260,2018.csv,2018,61.2%,38.8%
2479,All the Pretty Horses,18133495,15540353,2593142,2000.csv,2000,85.7%,14.3%
2480,Dead Man Down,18074539,10895295,7179244,2013.csv,2013,60.3%,39.7%
2481,Blinded by the Light,18019198,11901145,6118053,2019.csv,2019,66%,34%
2482,The Country Bears,18012097,16990825,1021272,2002.csv,2002,94.3%,5.7%
2483,Quills,17989227,7065332,10923895,2000.csv,2000,39.3%,60.7%
2484,Kalank,17987034,2729336,15257698,2019.csv,2019,15.2%,84.8%
2485,Dope,17986781,17506470,480311,2015.csv,2015,97.3%,2.7%
2486,Cantinflas,17966873,6382924,11583949,2014.csv,2014,35.5%,64.5%
2487,Night Watch 2005 Re-release,17939389,1502188,16437201,2005.csv,2005,8.4%,91.6%
2488,We Have a Pope,17877523,548115,17329408,2011.csv,2011,3.1%,96.9%
2489,The Old Man & the Gun,17860397,11277120,6583277,2018.csv,2018,63.1%,36.9%
2490,The Quiet Ones,17835162,8509867,9325295,2014.csv,2014,47.7%,52.3%
2491,Unforgettable,17768012,11368012,6400000,2017.csv,2017,64%,36%
2492,The Last Kiss,17720347,1048950,16671397,2002.csv,2002,5.9%,94.1%
2493,Joyeux Noel,17709155,1054361,16654794,2005.csv,2005,6%,94%
2494,The Children Act,17696794,547750,17149044,2018.csv,2018,3.1%,96.9%
2495,Regression,17671101,55039,17616062,2015.csv,2015,0.3%,99.7%
2496,Before I Go to Sleep,17669776,3242457,14427319,2014.csv,2014,18.4%,81.6%
2497,Neerja,17618280,1585687,16032593,2015.csv,2015,9%,91%
2498,Operation Finale,17612099,17612099,0,2018.csv,2018,100%,-
2499,Deliver Us from Eva,17573594,17573594,0,2003.csv,2003,100%,-
2500,Little Boy,17572289,6485961,11086328,2015.csv,2015,36.9%,63.1%
2501,Toilet: A Love Story,17567417,1830715,15736702,2017.csv,2017,10.4%,89.6%
2502,Loving Pablo,17535962,22017,17513945,2018.csv,2018,0.1%,99.9%
2503,Addicted,17534314,17390770,143544,2014.csv,2014,99.2%,0.8%
2504,Roll Bounce,17500866,17380866,120000,2005.csv,2005,99.3%,0.7%
2505,Machete Kills,17496820,8008161,9488659,2013.csv,2013,45.8%,54.2%
2506,Rebound,17492014,16809014,683000,2005.csv,2005,96.1%,3.9%
2507,A Guy Thing,17432163,15545431,1886732,2003.csv,2003,89.2%,10.8%
2508,Frailty,17423030,13110448,4312582,2002.csv,2002,75.2%,24.8%
2509,Fate/Stay Night: Heaven's Feel - I. Presage Flower,17422935,193833,17229102,2017.csv,2017,1.1%,98.9%
2510,Stolen,17415418,304318,17111100,2012.csv,2012,1.7%,98.3%
2511,Kapoor & Sons,17412627,2607036,14805591,2016.csv,2016,15%,85%
2512,Boule & Bill,17400053,894,17399159,2013.csv,2013,<0.1%,100%
2513,Fruitvale Station,17385830,16101339,1284491,2013.csv,2013,92.6%,7.4%
2514,The Matador,17347231,12594698,4752533,2005.csv,2005,72.6%,27.4%
2515,Fate/stay night [Heaven's Feel] II. lost butterfly,17295864,420595,16875269,2019.csv,2019,2.4%,97.6%
2516,The Importance of Being Earnest,17290970,8384929,8906041,2002.csv,2002,48.5%,51.5%
2517,While We're Young,17287309,7587485,9699824,2015.csv,2015,43.9%,56.1%
2518,Legend of the Naga Pearls,17274695,13588,17261107,2017.csv,2017,<0.1%,99.9%
2519,The Hunt,17170145,613308,16556837,2012.csv,2012,3.6%,96.4%
2520,My Afternoons with Margueritte,17107143,666557,16440586,2010.csv,2010,3.9%,96.1%
2521,Kinsey,17050017,10254979,6795038,2004.csv,2004,60.1%,39.9%
2522,Melancholia,17039814,3030848,14008966,2011.csv,2011,17.8%,82.2%
2523,Beyond Outrage,17027515,3878,17023637,2012.csv,2012,<0.1%,100%
2524,Kung Pow: Enter the Fist,16994625,16037962,956663,2002.csv,2002,94.4%,5.6%
2525,Chinese Puzzle,16968297,338523,16629774,2013.csv,2013,2%,98%
2526,Jason X,16951798,13121555,3830243,2001.csv,2001,77.4%,22.6%
2527,Catch That Kid,16951702,16703799,247903,2004.csv,2004,98.5%,1.5%
2528,The Nutcracker in 3D,16918946,195459,16723487,2010.csv,2010,1.2%,98.8%
2529,Sugar & Spice,16908947,13305101,3603846,2001.csv,2001,78.7%,21.3%
2530,Calvary,16887741,3600006,13287735,2014.csv,2014,21.3%,78.7%
2531,Life or Something Like It,16872671,14448589,2424082,2002.csv,2002,85.6%,14.4%
2532,The Last Godfather,16863629,164247,16699382,2010.csv,2010,1%,99%
2533,The Cold Light of Day,16863583,3763583,13100000,2012.csv,2012,22.3%,77.7%
2534,The Pyramid,16861137,2756333,14104804,2014.csv,2014,16.3%,83.7%
2535,The Good Girl,16856124,14018296,2837828,2002.csv,2002,83.2%,16.8%
2536,Monkey Kingdom,16839663,16432322,407341,2015.csv,2015,97.6%,2.4%
2537,Femme Fatale,16838910,6630252,10208658,2002.csv,2002,39.4%,60.6%
2538,House of 1000 Corpses,16829545,12634962,4194583,2003.csv,2003,75.1%,24.9%
2539,Hit and Run,16816647,13749300,3067347,2012.csv,2012,81.8%,18.2%
2540,Hardcore Henry,16810562,9252038,7558524,2016.csv,2016,55%,45%
2541,Paparazzi,16796512,15714234,1082278,2004.csv,2004,93.6%,6.4%
2542,The Birth of a Nation,16779212,15861566,917646,2016.csv,2016,94.5%,5.5%
2543,House of Sand and Fog,16763804,13040288,3723516,2003.csv,2003,77.8%,22.2%
2544,102 Not Out,16758596,1343797,15414799,2018.csv,2018,8%,92%
2545,Love Is All You Need,16722143,1631709,15090434,2012.csv,2012,9.8%,90.2%
2546,Delhi Belly,16706074,1532594,15173480,2011.csv,2011,9.2%,90.8%
2547,Pride,16699029,1446634,15252395,2014.csv,2014,8.7%,91.3%
2548,Dogville,16680836,1535286,15145550,2003.csv,2003,9.2%,90.8%
2549,CyberWorld,16653900,11253900,5400000,2000.csv,2000,67.6%,32.4%
2550,My Way,16653488,70177,16583311,2011.csv,2011,0.4%,99.6%
2551,Digimon: The Movie,16643191,9631153,7012038,2000.csv,2000,57.9%,42.1%
2552,Beautiful Boy,16636604,7649973,8986631,2018.csv,2018,46%,54%
2553,Nothing to Lose 2,16610713,1150551,15460162,2019.csv,2019,6.9%,93.1%
2554,Belle,16607575,10726630,5880945,2014.csv,2014,64.6%,35.4%
2555,Upgrade,16593554,11977130,4616424,2018.csv,2018,72.2%,27.8%
2556,The Dish,16575074,2552992,14022082,2000.csv,2000,15.4%,84.6%
2557,Tazza: One-Eyed Jack,16572611,97655,16474956,2019.csv,2019,0.6%,99.4%
2558,Battle of the Year,16549477,8888355,7661122,2013.csv,2013,53.7%,46.3%
2559,"Tomorrow, When the War Began",16533595,4936,16528659,2010.csv,2010,<0.1%,100%
2560,Silent House,16527747,12754783,3772964,2012.csv,2012,77.2%,22.8%
2561,Pride and Prejudice and Zombies,16457494,10938134,5519360,2016.csv,2016,66.5%,33.5%
2562,They,16446271,12840842,3605429,2002.csv,2002,78.1%,21.9%
2563,The Powerpuff Girls Movie,16426471,11412414,5014057,2002.csv,2002,69.5%,30.5%
2564,Poms,16418218,13631124,2787094,2019.csv,2019,83%,17%
2565,Forever My Girl,16376066,16376066,0,2018.csv,2018,100%,-
2566,Before I Fall,16373843,12241122,4132721,2017.csv,2017,74.8%,25.2%
2567,The Magdalene Sisters,16373112,306989,16066123,2002.csv,2002,1.9%,98.1%
2568,The Single Moms Club,16365451,15973881,391570,2014.csv,2014,97.6%,2.4%
2569,Little Q,16360233,1652,16358581,2019.csv,2019,<0.1%,100%
2570,Italian for Beginners,16349568,4544753,11804815,2000.csv,2000,27.8%,72.2%
2571,Playmobil: The Movie,16349303,1115008,15234295,2019.csv,2019,6.8%,93.2%
2572,Macbeth,16322067,1110707,15211360,2015.csv,2015,6.8%,93.2%
2573,The Emperor's Club,16318449,14118751,2199698,2002.csv,2002,86.5%,13.5%
2574,Rabbit-Proof Fence,16217411,6199600,10017811,2002.csv,2002,38.2%,61.8%
2575,Caché,16197824,3647381,12550443,2005.csv,2005,22.5%,77.5%
2576,Gangnam Blues,16191434,18022,16173412,2015.csv,2015,0.1%,99.9%
2577,In the House,16190771,389757,15801014,2012.csv,2012,2.4%,97.6%
2578,Just Visiting,16176732,4781539,11395193,2001.csv,2001,29.6%,70.4%
2579,Birthday Girl,16171098,5142576,11028522,2002.csv,2002,31.8%,68.2%
2580,Iris,16153953,5594617,10559336,2001.csv,2001,34.6%,65.4%
2581,Scouts Guide to the Zombie Apocalypse,16137046,3703046,12434000,2015.csv,2015,22.9%,77.1%
2582,The Space Between Us,16080475,7885294,8195181,2017.csv,2017,49%,51%
2583,To Be and to Have,16063920,777129,15286791,2002.csv,2002,4.8%,95.2%
2584,Unfriended: Dark Web,16024987,8866745,7158242,2018.csv,2018,55.3%,44.7%
2585,Sea Rex 3D: Journey to a Prehistoric World,16004150,6096582,9907568,2010.csv,2010,38.1%,61.9%
2586,What the #$*! Do We (K)now!?,15998178,10942306,5055872,2004.csv,2004,68.4%,31.6%
2587,The Kitchen,15980032,12180032,3800000,2019.csv,2019,76.2%,23.8%
2588,The Words,15950164,11494838,4455326,2012.csv,2012,72.1%,27.9%
2589,Before Sunset,15936507,5820649,10115858,2004.csv,2004,36.5%,63.5%
2590,Drowning Mona,15906764,15506764,400000,2000.csv,2000,97.5%,2.5%
2591,Wonder Wheel,15889124,1404061,14485063,2017.csv,2017,8.8%,91.2%
2592,Finding Your Feet,15845593,1418682,14426911,2018.csv,2018,9%,91%
2593,Highlander: Endgame,15843608,12811858,3031750,2000.csv,2000,80.9%,19.1%
2594,"I, Daniel Blake",15793051,260354,15532697,2016.csv,2016,1.6%,98.4%
2595,The Great Yokai War,15787492,0,15787492,2005.csv,2005,-,100%
2596,Kiss Kiss Bang Bang,15785148,4243756,11541392,2005.csv,2005,26.9%,73.1%
2597,The Gospel,15778152,15778152,0,2005.csv,2005,100%,-
2598,Lantana,15747450,4623189,11124261,2001.csv,2001,29.4%,70.6%
2599,I Hate Luv Storys,15719212,847993,14871219,2010.csv,2010,5.4%,94.6%
2600,The Brand New Testament,15709652,127910,15581742,2015.csv,2015,0.8%,99.2%
2601,Enigma 2001 Re-release,15705007,4301582,11403425,2001.csv,2001,27.4%,72.6%
2602,Feng Shui,15702302,64147,15638155,2018.csv,2018,0.4%,99.6%
2603,Judy Moody and the Not Bummer Summer,15691640,15013650,677990,2011.csv,2011,95.7%,4.3%
2604,Out of the Furnace,15660668,11330849,4329819,2013.csv,2013,72.4%,27.6%
2605,Vampire Academy,15642346,7791979,7850367,2014.csv,2014,49.8%,50.2%
2606,Tully,15636462,9369755,6266707,2018.csv,2018,59.9%,40.1%
2607,The Conspirator,15623183,11538204,4084979,2011.csv,2011,73.9%,26.1%
2608,Facing Windows,15530077,543354,14986723,2003.csv,2003,3.5%,96.5%
2609,Paranoia,15500644,7388654,8111990,2013.csv,2013,47.7%,52.3%
2610,With a Friend Like Harry...,15472186,3830441,11641745,2001.csv,2001,24.8%,75.2%
2611,Bait,15471969,15325127,146842,2000.csv,2000,99.1%,0.9%
2612,Zelary,15461305,330033,15131272,2003.csv,2003,2.1%,97.9%
2613,Chronicles of Evil,15460494,105057,15355437,2015.csv,2015,0.7%,99.3%
2614,The Greatest Game Ever Played,15431177,15337393,93784,2005.csv,2005,99.4%,0.6%
2615,Our Little Sister,15407615,64441,15343174,2015.csv,2015,0.4%,99.6%
2616,Anonymous,15395087,4463292,10931795,2011.csv,2011,29%,71%
2617,Miss Bala,15383580,15006824,376756,2019.csv,2019,97.6%,2.4%
2618,Alex & Emma,15368897,14218698,1150199,2003.csv,2003,92.5%,7.5%
2619,Apollo 11,15342353,9039891,6302462,2019.csv,2019,58.9%,41.1%
2620,Brother,15250594,450594,14800000,2001.csv,2001,3%,97%
2621,Hey Arnold! The Movie,15249308,13728902,1520406,2002.csv,2002,90%,10%
2622,The Negotiation,15229193,110986,15118207,2018.csv,2018,0.7%,99.3%
2623,Attack on Titan II: End of the World,15186410,305934,14880476,2015.csv,2015,2%,98%
2624,Tamasha,15159762,2065487,13094275,2015.csv,2015,13.6%,86.4%
2625,Transamerica,15151744,9015303,6136441,2005.csv,2005,59.5%,40.5%
2626,Extraordinary Measures,15134293,12068313,3065980,2010.csv,2010,79.7%,20.3%
2627,Irreplaceable,15130912,8494,15122418,2016.csv,2016,<0.1%,99.9%
2628,Surviving Christmas,15125687,11663156,3462531,2004.csv,2004,77.1%,22.9%
2629,Three,15121228,119550,15001678,2016.csv,2016,0.8%,99.2%
2630,The Dreamers,15121165,2532228,12588937,2003.csv,2003,16.7%,83.3%
2631,War of the Buttons,15082409,47771,15034638,2011.csv,2011,0.3%,99.7%
2632,Ip Man 2,15061802,205675,14856127,2010.csv,2010,1.4%,98.6%
2633,The Housemaid,15038301,157961,14880340,2010.csv,2010,1.1%,98.9%
2634,Boat Trip,15020293,8600126,6420167,2002.csv,2002,57.3%,42.7%
2635,Journey to the South Pacific,14994876,7653913,7340963,2013.csv,2013,51%,49%
2636,Oldboy,14980005,707481,14272524,2003.csv,2003,4.7%,95.3%
2637,Undisputed,14946150,12764657,2181493,2002.csv,2002,85.4%,14.6%
2638,Blue Valentine,14892418,9706328,5186090,2010.csv,2010,65.2%,34.8%
2639,Gold,14880939,7227038,7653901,2017.csv,2017,48.6%,51.4%
2640,School of Life,14880497,6300,14874197,2017.csv,2017,<0.1%,100%
2641,Raise Your Voice,14867514,10411980,4455534,2004.csv,2004,70%,30%
2642,Josie and the Pussycats,14866015,14271015,595000,2001.csv,2001,96%,4%
2643,Emperor,14858240,3346265,11511975,2013.csv,2013,22.5%,77.5%
2644,The Take,14857808,50269,14807539,2016.csv,2016,0.3%,99.7%
2645,Supernova,14828081,14230455,597626,2000.csv,2000,96%,4%
2646,Soul Plane,14821824,14190750,631074,2004.csv,2004,95.7%,4.3%
2647,Possession,14815898,10113733,4702165,2002.csv,2002,68.3%,31.7%
2648,Somewhere,14788642,1785645,13002997,2010.csv,2010,12.1%,87.9%
2649,Out Cold,14782676,13906394,876282,2001.csv,2001,94.1%,5.9%
2650,Seondal: The Man Who Sells the River,14777982,97477,14680505,2016.csv,2016,0.7%,99.3%
2651,The Triplets of Belleville,14776760,7007149,7769611,2003.csv,2003,47.4%,52.6%
2652,A Royal Affair,14758997,1546761,13212236,2012.csv,2012,10.5%,89.5%
2653,Sword Master,14714624,75526,14639098,2016.csv,2016,0.5%,99.5%
2654,Inherent Vice,14710975,8110975,6600000,2014.csv,2014,55.1%,44.9%
2655,Iron Monkey,14694904,14694904,0,2001.csv,2001,100%,-
2656,The Way Back,14690514,13590514,1100000,2020.csv,2020,92.5%,7.5%
2657,Together with You,14687167,1151941,13535226,2003.csv,2003,7.8%,92.2%
2658,"Hello, My Name Is Doris",14659448,14444999,214449,2016.csv,2016,98.5%,1.5%
2659,Beyond the Lights,14618727,14618727,0,2014.csv,2014,100%,-
2660,Welcome to Mooseport,14615099,14470947,144152,2004.csv,2004,99%,1%
2661,Together,14572229,1034829,13537400,2001.csv,2001,7.1%,92.9%
2662,Hollywood Ending,14569744,4850753,9718991,2002.csv,2002,33.3%,66.7%
2663,Megan Leavey,14510490,13406883,1103607,2017.csv,2017,92.4%,7.6%
2664,The Dead Don't Die,14502830,6563605,7939225,2019.csv,2019,45.3%,54.7%
2665,Envy,14494036,13562325,931711,2004.csv,2004,93.6%,6.4%
2666,Malena,14493284,3448233,11045051,2000.csv,2000,23.8%,76.2%
2667,A United Kingdom,14459330,3902185,10557145,2016.csv,2016,27%,73%
2668,Serenity,14454622,8547045,5907577,2019.csv,2019,59.1%,40.9%
2669,America: Imagine the World Without Her,14444502,14444502,0,2014.csv,2014,100%,-
2670,RBG,14441292,14017361,423931,2018.csv,2018,97.1%,2.9%
2671,Unfinished Business,14431253,10219501,4211752,2015.csv,2015,70.8%,29.2%
2672,45 Years,14430249,4247285,10182964,2015.csv,2015,29.4%,70.6%
2673,Do You Believe?,14410698,12985600,1425098,2015.csv,2015,90.1%,9.9%
2674,Woodlawn,14401617,14394097,7520,2015.csv,2015,99.9%,<0.1%
2675,I Dreamed of Africa,14400327,6651522,7748805,2000.csv,2000,46.2%,53.8%
2676,How to Deal,14390329,14195227,195102,2003.csv,2003,98.6%,1.4%
2677,Eighth Grade,14347433,13539709,807724,2018.csv,2018,94.4%,5.6%
2678,Thugs of Hindostan,14341431,1449848,12891583,2018.csv,2018,10.1%,89.9%
2679,Being Julia,14339171,7739049,6600122,2004.csv,2004,54%,46%
2680,Freddy Got Fingered,14333252,14254993,78259,2001.csv,2001,99.5%,0.5%
2681,The Other Side of the Door,14332467,3000342,11332125,2016.csv,2016,20.9%,79.1%
2682,Beginners,14311701,5790894,8520807,2011.csv,2011,40.5%,59.5%
2683,The Beauty Inside,14301869,108083,14193786,2015.csv,2015,0.8%,99.2%
2684,La Belle Époque,14298084,0,14298084,2020.csv,2020,-,100%
2685,Unsane,14293601,7732899,6560702,2018.csv,2018,54.1%,45.9%
2686,Stealing Harvard,14277032,14036406,240626,2002.csv,2002,98.3%,1.7%
2687,Colette,14273033,5137622,9135411,2018.csv,2018,36%,64%
2688,Proof,14189860,7535331,6654529,2005.csv,2005,53.1%,46.9%
2689,What Planet Are You From?,14145677,6291602,7854075,2000.csv,2000,44.5%,55.5%
2690,Ya veremos,14134723,4165949,9968774,2018.csv,2018,29.5%,70.5%
2691,Shaandaar,14120808,521794,13599014,2015.csv,2015,3.7%,96.3%
2692,Red Lights,14107313,52624,14054689,2012.csv,2012,0.4%,99.6%
2693,Seeking Justice,14089528,411746,13677782,2011.csv,2011,2.9%,97.1%
2694,Island of Lemurs: Madagascar,14066534,11272213,2794321,2014.csv,2014,80.1%,19.9%
2695,Osmosis Jones,14026418,13596911,429507,2001.csv,2001,96.9%,3.1%
2696,Ghosts of Mars,14010832,8709640,5301192,2001.csv,2001,62.2%,37.8%
2697,Dirty Pretty Things,13904766,8112414,5792352,2002.csv,2002,58.3%,41.7%
2698,Touching the Void,13885802,4593598,9292204,2003.csv,2003,33.1%,66.9%
2699,The Quake,13837294,6235,13831059,2018.csv,2018,<0.1%,100%
2700,House of the Dead,13818181,10249719,3568462,2003.csv,2003,74.2%,25.8%
2701,Juwanna Mann,13802599,13670733,131866,2002.csv,2002,99%,1%
2702,Winter's Bone,13796834,6531503,7265331,2010.csv,2010,47.3%,52.7%
2703,The Ladies Man,13743212,13616610,126602,2000.csv,2000,99.1%,0.9%
2704,Pulling Strings,13725819,5842961,7882858,2013.csv,2013,42.6%,57.4%
2705,American Outlaws,13678913,13342790,336123,2001.csv,2001,97.5%,2.5%
2706,Phantom,13676590,489984,13186606,2015.csv,2015,3.6%,96.4%
2707,All Is Lost,13627519,6263670,7363849,2013.csv,2013,46%,54%
2708,Sing Street,13624522,3237118,10387404,2016.csv,2016,23.8%,76.2%
2709,Do It Like An Hombre,13610252,2534252,11076000,2017.csv,2017,18.6%,81.4%
2710,Love Forecast,13608637,32211,13576426,2015.csv,2015,0.2%,99.8%
2711,Strange Magic,13603453,12429583,1173870,2015.csv,2015,91.4%,8.6%
2712,Anything Else,13585075,3212310,10372765,2003.csv,2003,23.6%,76.4%
2713,The Two Faces of January,13551951,507463,13044488,2014.csv,2014,3.7%,96.3%
2714,Nymphomaniac: Vol. I,13545832,785896,12759936,2013.csv,2013,5.8%,94.2%
2715,Phantom of the Theatre,13526843,43955,13482888,2016.csv,2016,0.3%,99.7%
2716,The Man,13485145,8330720,5154425,2005.csv,2005,61.8%,38.2%
2717,One Night at McCool's,13473370,6290673,7182697,2001.csv,2001,46.7%,53.3%
2718,The Lord of the Rings: The Two Towers 2003 Re-release,13451150,1996877,11454273,2003.csv,2003,14.8%,85.2%
2719,Three Identical Strangers,13448497,12320845,1127652,2018.csv,2018,91.6%,8.4%
2720,Trapped,13414416,7073251,6341165,2002.csv,2002,52.7%,47.3%
2721,Lords of Dogtown,13411957,11273517,2138440,2005.csv,2005,84.1%,15.9%
2722,The Third Murder,13411936,89315,13322621,2017.csv,2017,0.7%,99.3%
2723,Solarmax,13400161,13400161,0,2000.csv,2000,100%,-
2724,Our President,13392049,507268,12884781,2017.csv,2017,3.8%,96.2%
2725,Ratchet & Clank,13385737,8821329,4564408,2016.csv,2016,65.9%,34.1%
2726,RRRrrrr!!!,13315054,54361,13260693,2004.csv,2004,0.4%,99.6%
2727,Hotel Artemis,13313581,6708147,6605434,2018.csv,2018,50.4%,49.6%
2728,Vera Drake,13267869,3775283,9492586,2004.csv,2004,28.5%,71.5%
2729,Paris Can Wait,13203541,5617731,7585810,2017.csv,2017,42.5%,57.5%
2730,Kal ho naa ho,13200241,1991922,11208319,2003.csv,2003,15.1%,84.9%
2731,The Well-Digger's Daughter,13194167,386368,12807799,2011.csv,2011,2.9%,97.1%
2732,The Honeymooners,13183426,12843849,339577,2005.csv,2005,97.4%,2.6%
2733,Mommy,13156856,3494070,9662786,2014.csv,2014,26.6%,73.4%
2734,The Sisters Brothers,13143056,3143056,10000000,2018.csv,2018,23.9%,76.1%
2735,Head Over Heels,13127022,10424470,2702552,2001.csv,2001,79.4%,20.6%
2736,The Crew,13105853,13023075,82778,2000.csv,2000,99.4%,0.6%
2737,Hillary's America: The Secret History of the Democratic Party,13099931,13099931,0,2016.csv,2016,100%,-
2738,The Angels' Share,13090471,346669,12743802,2012.csv,2012,2.6%,97.4%
2739,Shut In,13082071,6900335,6181736,2016.csv,2016,52.7%,47.3%
2740,Hot Tub Time Machine 2,13081651,12314651,767000,2015.csv,2015,94.1%,5.9%
2741,The Way of the Gun,13069740,6055661,7014079,2000.csv,2000,46.3%,53.7%
2742,The Barbarian Invasions,13065317,5109226,7956091,2003.csv,2003,39.1%,60.9%
2743,Welcome to Marwen,13061491,10763520,2297971,2018.csv,2018,82.4%,17.6%
2744,"Roman J. Israel, Esq.",13025860,11962778,1063082,2017.csv,2017,91.8%,8.2%
2745,Friends with Kids,13019073,7251073,5768000,2012.csv,2012,55.7%,44.3%
2746,The Vatican Tapes,13015764,1784763,11231001,2015.csv,2015,13.7%,86.3%
2747,In a Better World,13004504,1008098,11996406,2010.csv,2010,7.8%,92.2%
2748,The Divorce,12991996,9081057,3910939,2003.csv,2003,69.9%,30.1%
2749,Pyaar Ka Punchnama 2,12983721,222856,12760865,2015.csv,2015,1.7%,98.3%
2750,The Wave,12975143,177404,12797739,2015.csv,2015,1.4%,98.6%
2751,I Saw the Devil,12966357,129210,12837147,2010.csv,2010,1%,99%
2752,Le Havre,12959706,611709,12347997,2011.csv,2011,4.7%,95.3%
2753,Loving,12957265,7751969,5205296,2016.csv,2016,59.8%,40.2%
2754,Child 44,12951093,1224330,11726763,2015.csv,2015,9.5%,90.5%
2755,Godzilla 2000,12924063,10037390,2886673,2000.csv,2000,77.7%,22.3%
2756,Gods and Generals,12923936,12882934,41002,2003.csv,2003,99.7%,0.3%
2757,Take Point,12908032,112386,12795646,2018.csv,2018,0.9%,99.1%
2758,Mubarakan,12899968,758868,12141100,2017.csv,2017,5.9%,94.1%
2759,Formula 51,12881605,5204007,7677598,2001.csv,2001,40.4%,59.6%
2760,In the Mood for Love,12854953,2738980,10115973,2000.csv,2000,21.3%,78.7%
2761,Earth: One Amazing Day,12851540,81345,12770195,2017.csv,2017,0.6%,99.4%
2762,The Girl from Paris,12812396,183266,12629130,2001.csv,2001,1.4%,98.6%
2763,Knockaround Guys,12806614,11715637,1090977,2002.csv,2002,91.5%,8.5%
2764,Aliens of the Deep,12770637,8968684,3801953,2005.csv,2005,70.2%,29.8%
2765,Suburbicon,12751667,5775178,6976489,2017.csv,2017,45.3%,54.7%
2766,Elle,12748594,2341534,10407060,2016.csv,2016,18.4%,81.6%
2767,Populaire,12698385,179091,12519294,2012.csv,2012,1.4%,98.6%
2768,The Past,12673462,1331747,11341715,2013.csv,2013,10.5%,89.5%
2769,"Remember Me, My Love",12671306,227986,12443320,2003.csv,2003,1.8%,98.2%
2770,Redemption,12671109,36895,12634214,2013.csv,2013,0.3%,99.7%
2771,The Green Inferno,12666449,7192291,5474158,2015.csv,2015,56.8%,43.2%
2772,Chasing Papi,12661189,6130049,6531140,2003.csv,2003,48.4%,51.6%
2773,Winged Migration 2003 Re-release,12634963,10764402,1870561,2003.csv,2003,85.2%,14.8%
2774,Narc,12633747,10465659,2168088,2002.csv,2002,82.8%,17.2%
2775,Made in Dagenham,12629471,1095369,11534102,2010.csv,2010,8.7%,91.3%
2776,Luis and the Aliens,12627729,169710,12458019,2018.csv,2018,1.3%,98.7%
2777,Raajneeti,12604224,1514558,11089666,2010.csv,2010,12%,88%
2778,Their Finest,12597262,3603484,8993778,2017.csv,2017,28.6%,71.4%
2779,Maria Full of Grace,12594630,6529624,6065006,2004.csv,2004,51.8%,48.2%
2780,Gossip,12591270,5108820,7482450,2000.csv,2000,40.6%,59.4%
2781,People Like Us,12558931,12434778,124153,2012.csv,2012,99%,1%
2782,Breakin' All the Rules,12544254,12264319,279935,2004.csv,2004,97.8%,2.2%
2783,Apocalypse Now Redux 2001 Re-release,12543269,4626290,7916979,2001.csv,2001,36.9%,63.1%
2784,The Clearing,12520799,5763875,6756924,2004.csv,2004,46%,54%
2785,Sorority Boys,12517488,10200032,2317456,2002.csv,2002,81.5%,18.5%
2786,Seducing Doctor Lewis,12504038,9354342,3149696,2003.csv,2003,74.8%,25.2%
2787,Ready to Rumble,12452362,12394327,58035,2000.csv,2000,99.5%,0.5%
2788,The Promise,12448676,8224288,4224388,2017.csv,2017,66.1%,33.9%
2789,Can You Ever Forgive Me?,12442161,8803865,3638296,2018.csv,2018,70.8%,29.2%
2790,Nine Queens,12413888,1222889,11190999,2002.csv,2002,9.9%,90.1%
2791,Monsieur Ibrahim,12364836,2823890,9540946,2003.csv,2003,22.8%,77.2%
2792,Rampant,12359573,167937,12191636,2018.csv,2018,1.4%,98.6%
2793,Tall Tales from the Magical Garden of Antoon Krings 2018 Re-release,12353849,220,12353629,2018.csv,2018,<0.1%,100%
2794,Casshern,12353768,0,12353768,2004.csv,2004,-,100%
2795,Say It Isn't So,12320393,5520393,6800000,2001.csv,2001,44.8%,55.2%
2796,Chasing Liberty,12313323,12195626,117697,2004.csv,2004,99%,1%
2797,Abandon,12302219,10727683,1574536,2002.csv,2002,87.2%,12.8%
2798,Marrowbone,12294931,1377,12293554,2017.csv,2017,<0.1%,100%
2799,The Beatles: Eight Days a Week - The Touring Years,12283800,2930414,9353386,2016.csv,2016,23.9%,76.1%
2800,The Man Who Knew Infinity,12252684,3866794,8385890,2016.csv,2016,31.6%,68.4%
2801,Gainsbourg: A Heroic Life,12220456,233007,11987449,2010.csv,2010,1.9%,98.1%
2802,The Guillotines,12217440,5290,12212150,2012.csv,2012,<0.1%,100%
2803,I Married an Anti-Fan,12194083,89408,12104675,2016.csv,2016,0.7%,99.3%
2804,Koi... Mil Gaya,12168232,671372,11496860,2003.csv,2003,5.5%,94.5%
2805,Little Women,12165890,1379497,10786393,2018.csv,2018,11.3%,88.7%
2806,The Eye,12165016,512049,11652967,2002.csv,2002,4.2%,95.8%
2807,My Big Fat Independent Movie,12155249,4655,12150594,2005.csv,2005,<0.1%,100%
2808,Dark Blue,12150301,9250301,2900000,2003.csv,2003,76.1%,23.9%
2809,Miss & Mrs. Cops,12147170,104578,12042592,2019.csv,2019,0.9%,99.1%
2810,Bachelorette,12128575,447954,11680621,2012.csv,2012,3.7%,96.3%
2811,Barney's Version,12104765,4439201,7665564,2011.csv,2011,36.7%,63.3%
2812,Stoker,12077441,1714221,10363220,2012.csv,2012,14.2%,85.8%
2813,Don't Move,12071007,337265,11733742,2004.csv,2004,2.8%,97.2%
2814,The Connection,12062441,190980,11871461,2014.csv,2014,1.6%,98.4%
2815,The Bookshop,12055868,1588150,10467718,2017.csv,2017,13.2%,86.8%
2816,Three Burials,12045362,5027684,7017678,2005.csv,2005,41.7%,58.3%
2817,Tamara Drewe,12037973,560391,11477582,2010.csv,2010,4.7%,95.3%
2818,I Am Love,12014663,5005465,7009198,2010.csv,2010,41.7%,58.3%
2819,The Cookout,12009070,11814019,195051,2004.csv,2004,98.4%,1.6%
2820,A Most Violent Year,12007070,5749134,6257936,2014.csv,2014,47.9%,52.1%
2821,The Assassin,11991669,632542,11359127,2015.csv,2015,5.3%,94.7%
2822,This Must Be the Place,11928909,143979,11784930,2011.csv,2011,1.2%,98.8%
2823,The Polar Express 2005 IMAX Release,11910480,10900597,1009883,2005.csv,2005,91.5%,8.5%
2824,The Warring States,11868961,68961,11800000,2011.csv,2011,0.6%,99.4%
2825,Viceroy's House,11868221,1105717,10762504,2017.csv,2017,9.3%,90.7%
2826,Boy Erased,11853081,6788692,5064389,2018.csv,2018,57.3%,42.7%
2827,Layer Cake,11850214,2339957,9510257,2004.csv,2004,19.7%,80.3%
2828,Unstoppable,11845347,101417,11743930,2018.csv,2018,0.9%,99.1%
2829,What Women Want,11838177,123526,11714651,2011.csv,2011,1%,99%
2830,Last Letter,11834622,180946,11653676,2018.csv,2018,1.5%,98.5%
2831,The Rules of Attraction,11819244,6532619,5286625,2002.csv,2002,55.3%,44.7%
2832,Ash Is Purest White,11813509,422814,11390695,2018.csv,2018,3.6%,96.4%
2833,Chloe,11808880,3075255,8733625,2010.csv,2010,26%,74%
2834,Getaway,11806432,10501938,1304494,2013.csv,2013,89%,11%
2835,Ballon,11799591,34222,11765369,2018.csv,2018,0.3%,99.7%
2836,The Divine Fury,11799556,102982,11696574,2019.csv,2019,0.9%,99.1%
2837,Win Win,11789613,10179275,1610338,2011.csv,2011,86.3%,13.7%
2838,Toni Erdmann,11784207,1479387,10304820,2016.csv,2016,12.6%,87.4%
2839,The Interview,11782625,6105175,5677450,2014.csv,2014,51.8%,48.2%
2840,Millions,11782282,6584159,5198123,2005.csv,2005,55.9%,44.1%
2841,The Son's Room,11767402,1016340,10751062,2001.csv,2001,8.6%,91.4%
2842,C'est Si Bon,11750035,164167,11585868,2015.csv,2015,1.4%,98.6%
2843,Beyond Borders,11705002,4430101,7274901,2003.csv,2003,37.8%,62.2%
2844,Seeking a Friend for the End of the World,11681781,7078738,4603043,2012.csv,2012,60.6%,39.4%
2845,Shopgirl,11675161,10284523,1390638,2005.csv,2005,88.1%,11.9%
2846,A Sound of Thunder,11665465,1900451,9765014,2005.csv,2005,16.3%,83.7%
2847,The Current War: Director's Cut,11662493,5979540,5682953,2019.csv,2019,51.3%,48.7%
2848,Back to Burgundy,11625884,257610,11368274,2017.csv,2017,2.2%,97.8%
2849,The Lunchbox 2013 Re-release,11621581,4235151,7386430,2013.csv,2013,36.4%,63.6%
2850,Delicacy,11597420,498584,11098836,2011.csv,2011,4.3%,95.7%
2851,The Order,11560806,7660806,3900000,2002.csv,2002,66.3%,33.7%
2852,The Legend of Drunken Master,11555430,11555430,0,2000.csv,2000,100%,-
2853,Haute Cuisine,11509942,217883,11292059,2012.csv,2012,1.9%,98.1%
2854,Fists of Legend,11478881,134213,11344668,2013.csv,2013,1.2%,98.8%
2855,Trumbo,11430025,7857741,3572284,2015.csv,2015,68.7%,31.3%
2856,Seasons,11425100,150092,11275008,2016.csv,2016,1.3%,98.7%
2857,Fun Size,11417362,9409538,2007824,2012.csv,2012,82.4%,17.6%
2858,Suspect Zero,11416075,8725813,2690262,2004.csv,2004,76.4%,23.6%
2859,Bring The Soul: The Movie,11393886,4809800,6584086,2019.csv,2019,42.2%,57.8%
2860,The King's Case Note,11383493,90959,11292534,2017.csv,2017,0.8%,99.2%
2861,King of Thieves,11353515,7518,11345997,2018.csv,2018,<0.1%,99.9%
2862,Bajirao Mastani,11350917,6557047,4793870,2015.csv,2015,57.8%,42.2%
2863,The Apparition,11350665,4936819,6413846,2012.csv,2012,43.5%,56.5%
2864,Snow Flower and the Secret Fan,11348205,1348205,10000000,2011.csv,2011,11.9%,88.1%
2865,Connie and Carla,11341016,8085771,3255245,2004.csv,2004,71.3%,28.7%
2866,Kabhi Khushi Kabhie Gham...,11329690,2902000,8427690,2001.csv,2001,25.6%,74.4%
2867,"It's Not You, It's Me",11301956,1339911,9962045,2010.csv,2010,11.9%,88.1%
2868,Tomorrow,11277905,62510,11215395,2015.csv,2015,0.6%,99.4%
2869,At Eternity's Gate,11261585,2294915,8966670,2018.csv,2018,20.4%,79.6%
2870,You Can Count on Me,11242521,9416804,1825717,2000.csv,2000,83.8%,16.2%
2871,Straw Dogs,11168712,10324441,844271,2010.csv,2010,92.4%,7.6%
2872,Ida,11156836,3827060,7329776,2013.csv,2013,34.3%,65.7%
2873,Shadow of the Vampire,11155214,8293784,2861430,2000.csv,2000,74.3%,25.7%
2874,Gloria Bell,11145006,5611123,5533883,2019.csv,2019,50.3%,49.7%
2875,Bicycling with Molière,11123929,59874,11064055,2013.csv,2013,0.5%,99.5%
2876,We Are Your Friends,11122090,3591417,7530673,2015.csv,2015,32.3%,67.7%
2877,Conviction 2010 Re-release,11104555,6783129,4321426,2010.csv,2010,61.1%,38.9%
2878,The Warrior's Way,11103434,5666340,5437094,2010.csv,2010,51%,49%
2879,The Squid and the Whale,11098131,7372734,3725397,2005.csv,2005,66.4%,33.6%
2880,The Belko Experiment,11084630,10166820,917810,2017.csv,2017,91.7%,8.3%
2881,Promised Land,11039031,7597898,3441133,2012.csv,2012,68.8%,31.2%
2882,Head-On,11030861,435395,10595466,2004.csv,2004,3.9%,96.1%
2883,Last Night,11027222,99000,10928222,2010.csv,2010,0.9%,99.1%
2884,La boda de Valentina,11021794,2783739,8238055,2018.csv,2018,25.3%,74.7%
2885,The Loft,11016443,6002684,5013759,2014.csv,2014,54.5%,45.5%
2886,Adrenaline Rush: The Science of Risk,11011932,10994028,17904,2002.csv,2002,99.8%,0.2%
2887,Gringo,11001627,4969853,6031774,2018.csv,2018,45.2%,54.8%
2888,[REC] 3: Genesis,10998667,9600,10989067,2012.csv,2012,<0.1%,99.9%
2889,The Beat That My Heart Skipped,10988397,1023424,9964973,2005.csv,2005,9.3%,90.7%
2890,Hyde Park on Hudson,10980481,6376145,4604336,2012.csv,2012,58.1%,41.9%
2891,Justin Bieber's Believe,10980157,6206566,4773591,2013.csv,2013,56.5%,43.5%
2892,District B13,10976892,1200216,9776676,2004.csv,2004,10.9%,89.1%
2893,Friend Request,10975390,3759078,7216312,2016.csv,2016,34.3%,65.7%
2894,The Florida Project,10971298,5904366,5066932,2017.csv,2017,53.8%,46.2%
2895,Extreme Ops,10959475,4842259,6117216,2002.csv,2002,44.2%,55.8%
2896,Jonah Hex,10903312,10547117,356195,2010.csv,2010,96.7%,3.3%
2897,One Chance,10900434,101196,10799238,2013.csv,2013,0.9%,99.1%
2898,A Bag of Marbles,10898998,411318,10487680,2017.csv,2017,3.8%,96.2%
2899,The Perfect Score,10898337,10391003,507334,2004.csv,2004,95.3%,4.7%
2900,The Darkness,10898293,10753574,144719,2016.csv,2016,98.7%,1.3%
2901,Lucky Numbers,10890222,10042516,847706,2000.csv,2000,92.2%,7.8%
2902,Here on Earth,10873148,10522168,350980,2000.csv,2000,96.8%,3.2%
2903,Steamboy,10870198,468867,10401331,2004.csv,2004,4.3%,95.7%
2904,Only You,10857889,61565,10796324,2015.csv,2015,0.6%,99.4%
2905,The Libertine,10852064,4835065,6016999,2005.csv,2005,44.6%,55.4%
2906,2.0,10847903,4152000,6695903,2018.csv,2018,38.3%,61.7%
2907,I'm Always Here,10836270,1747060,9089210,2004.csv,2004,16.1%,83.9%
2908,Danny Collins,10835752,5637066,5198686,2015.csv,2015,52%,48%
2909,Flying Monsters 3D with David Attenborough,10813862,5705874,5107988,2011.csv,2011,52.8%,47.2%
2910,Sophie Scholl: The Final Days,10804315,680331,10123984,2005.csv,2005,6.3%,93.7%
2911,Carandiru,10781635,216335,10565300,2004.csv,2004,2%,98%
2912,The Great Raid,10769311,10167373,601938,2005.csv,2005,94.4%,5.6%
2913,Golden Slumber,10733326,94450,10638876,2018.csv,2018,0.9%,99.1%
2914,Our Kind of Traitor,10711027,3153157,7557870,2016.csv,2016,29.4%,70.6%
2915,Prom,10702246,10130219,572027,2011.csv,2011,94.7%,5.3%
2916,The Sessions,10656155,6002451,4653704,2012.csv,2012,56.3%,43.7%
2917,Red Joan,10647493,1579730,9067763,2018.csv,2018,14.8%,85.2%
2918,Only God Forgives,10635126,779188,9855938,2013.csv,2013,7.3%,92.7%
2919,My Old Lady,10606667,4013786,6592881,2014.csv,2014,37.8%,62.2%
2920,Heartbreaker 2010 Re-release,10606371,504030,10102341,2010.csv,2010,4.8%,95.2%
2921,First Daughter,10592180,9055921,1536259,2004.csv,2004,85.5%,14.5%
2922,Pollock,10558970,8598593,1960377,2000.csv,2000,81.4%,18.6%
2923,The Phone,10551318,40516,10510802,2015.csv,2015,0.4%,99.6%
2924,Moms' Night Out,10536956,10429707,107249,2014.csv,2014,99%,1%
2925,Get Low,10522511,9176933,1345578,2010.csv,2010,87.2%,12.8%
2926,Anatomie,10501958,9660,10492298,2000.csv,2000,<0.1%,99.9%
2927,Intimate Strangers,10484574,2110589,8373985,2004.csv,2004,20.1%,79.9%
2928,I Still Believe,10482561,9868521,614040,2020.csv,2020,94.1%,5.9%
2929,The Leisure Seeker,10472180,3226443,7245737,2017.csv,2017,30.8%,69.2%
2930,The Cooler,10464788,8291572,2173216,2003.csv,2003,79.2%,20.8%
2931,Alone in the Dark,10442808,5178569,5264239,2005.csv,2005,49.6%,50.4%
2932,Mood Indigo,10435322,303187,10132135,2013.csv,2013,2.9%,97.1%
2933,Furious,10433259,9996,10423263,2017.csv,2017,<0.1%,99.9%
2934,Every Day,10421847,6102076,4319771,2018.csv,2018,58.6%,41.4%
2935,The Perfect Match,10414738,9669521,745217,2016.csv,2016,92.8%,7.2%
2936,"Where'd You Go, Bernadette",10411096,9198356,1212740,2019.csv,2019,88.4%,11.6%
2937,The Virgin Suicides,10409377,4906229,5503148,2000.csv,2000,47.1%,52.9%
2938,Swing Kids,10397408,222001,10175407,2018.csv,2018,2.1%,97.9%
2939,Lobster Cop,10373129,85693,10287436,2018.csv,2018,0.8%,99.2%
2940,Town & Country,10372291,6719973,3652318,2001.csv,2001,64.8%,35.2%
2941,Queen of Katwe,10367161,8874389,1492772,2016.csv,2016,85.6%,14.4%
2942,Wasabi,10366360,97220,10269140,2001.csv,2001,0.9%,99.1%
2943,Kin,10313019,5718096,4594923,2018.csv,2018,55.4%,44.6%
2944,The Babadook,10312540,964413,9348127,2014.csv,2014,9.4%,90.6%
2945,3-D Sex and Zen: Extreme Ecstasy,10306807,153215,10153592,2011.csv,2011,1.5%,98.5%
2946,Stone,10300416,1810078,8490338,2010.csv,2010,17.6%,82.4%
2947,Saved!,10275509,8940582,1334927,2004.csv,2004,87%,13%
2948,Girls vs Gangsters,10265819,37115,10228704,2018.csv,2018,0.4%,99.6%
2949,Chennai Express,10234653,5307960,4926693,2013.csv,2013,51.9%,48.1%
2950,The Miracle Season,10230620,10230620,0,2018.csv,2018,100%,-
2951,The Wash,10229331,10097538,131793,2001.csv,2001,98.7%,1.3%
2952,In the Mix,10223896,10223896,0,2005.csv,2005,100%,-
2953,Babies,10219306,7320323,2898983,2010.csv,2010,71.6%,28.4%
2954,The Best of Enemies,10209813,10205616,4197,2019.csv,2019,100%,<0.1%
2955,Senna,10197661,1612430,8585231,2010.csv,2010,15.8%,84.2%
2956,Woman on Top,10194274,5020111,5174163,2000.csv,2000,49.2%,50.8%
2957,For Greater Glory: The True Story of Cristiada,10173682,5672846,4500836,2012.csv,2012,55.8%,44.2%
2958,The Ice Harvest,10156968,9016782,1140186,2005.csv,2005,88.8%,11.2%
2959,Sleepover,10143022,9436390,706632,2004.csv,2004,93%,7%
2960,Ben Is Back,10134204,3703184,6431020,2018.csv,2018,36.5%,63.5%
2961,Thirteen,10128960,4601043,5527917,2003.csv,2003,45.4%,54.6%
2962,Trespass,10117966,24094,10093872,2011.csv,2011,0.2%,99.8%
2963,Marshall,10116816,10051659,65157,2017.csv,2017,99.4%,0.6%
2964,Iron Sky,10109659,122082,9987577,2012.csv,2012,1.2%,98.8%
2965,BTS World Tour: Love Yourself in Seoul,10109421,3509917,6599504,2019.csv,2019,34.7%,65.3%
2966,Bernie,10090641,9206470,884171,2012.csv,2012,91.2%,8.8%
2967,Pulse: A Stomp Odyssey,10086514,10086514,0,2002.csv,2002,100%,-
2968,A Little Chaos,10084623,558173,9526450,2015.csv,2015,5.5%,94.5%
2969,Gladiators of Rome,10079201,8201,10071000,2012.csv,2012,<0.1%,99.9%
2970,Papillon,10060903,2335896,7725007,2018.csv,2018,23.2%,76.8%
2971,A Day Without a Mexican,10057021,4179890,5877131,2004.csv,2004,41.6%,58.4%
2972,Sexy Beast,10045677,6946056,3099621,2001.csv,2001,69.1%,30.9%
2973,The Deep End,10031529,8823109,1208420,2001.csv,2001,88%,12%
2974,The King's Choice,10017316,113231,9904085,2016.csv,2016,1.1%,98.9%
2975,Kissing Jessica Stein,10013424,7025722,2987702,2002.csv,2002,70.2%,29.8%
2976,Elephant,10012022,1266955,8745067,2003.csv,2003,12.7%,87.3%
2977,Moonlight Mile,10011050,6835856,3175194,2002.csv,2002,68.3%,31.7%
2978,Thank You for Your Service,9995692,9536300,459392,2017.csv,2017,95.4%,4.6%
2979,Angel-A,9995168,202647,9792521,2005.csv,2005,2%,98%
2980,Alan Partridge,9979601,153426,9826175,2013.csv,2013,1.5%,98.5%
2981,Returner,9978256,73060,9905196,2002.csv,2002,0.7%,99.3%
2982,Kinky Boots,9950133,1822428,8127705,2005.csv,2005,18.3%,81.7%
2983,Cyrus,9933873,7468936,2464937,2010.csv,2010,75.2%,24.8%
2984,The Goldfinch,9932621,5332621,4600000,2019.csv,2019,53.7%,46.3%
2985,The Collection,9929706,6842058,3087648,2012.csv,2012,68.9%,31.1%
2986,Never Let Me Go,9904795,2434652,7470143,2010.csv,2010,24.6%,75.4%
2987,Whatever It Takes,9902115,8745680,1156435,2000.csv,2000,88.3%,11.7%
2988,The Princess and the Matchmaker,9899017,78900,9820117,2018.csv,2018,0.8%,99.2%
2989,Tsotsi,9891303,2912606,6978697,2005.csv,2005,29.4%,70.6%
2990,Simmba,9865268,5102129,4763139,2018.csv,2018,51.7%,48.3%
2991,Arctic Dogs,9860619,5801249,4059370,2019.csv,2019,58.8%,41.2%
2992,Mostly Martha,9852022,4160475,5691547,2002.csv,2002,42.2%,57.8%
2993,Mondays in the Sun,9832663,153256,9679407,2002.csv,2002,1.6%,98.4%
2994,3 Strikes,9832166,9832166,0,2000.csv,2000,100%,-
2995,Ghost in the Shell 2: Innocence,9789651,1043896,8745755,2004.csv,2004,10.7%,89.3%
2996,Young & Beautiful,9757417,61067,9696350,2013.csv,2013,0.6%,99.4%
2997,Tamjung Hong Gil-dong: Sarajin Ma-eul,9754195,67054,9687141,2016.csv,2016,0.7%,99.3%
2998,Maudie,9733932,6170998,3562934,2017.csv,2017,63.4%,36.6%
2999,My Life Without Me,9726954,400948,9326006,2003.csv,2003,4.1%,95.9%
3000,Bread and Tulips,9719848,5318679,4401169,2000.csv,2000,54.7%,45.3%
3001,Popstar: Never Stop Never Stopping,9680029,9639125,40904,2016.csv,2016,99.6%,0.4%
3002,Tod@s Caen,9667157,2670925,6996232,2019.csv,2019,27.6%,72.4%
3003,In Darkness,9661759,1041455,8620304,2012.csv,2012,10.8%,89.2%
3004,Overdrive,9650552,7793,9642759,2017.csv,2017,<0.1%,99.9%
3005,The Young Black Stallion,9638389,6751389,2887000,2003.csv,2003,70%,30%
3006,On the Road,9617377,744296,8873081,2012.csv,2012,7.7%,92.3%
3007,Private,9595697,15811,9579886,2005.csv,2005,0.2%,99.8%
3008,Paterson,9588282,2152738,7435544,2016.csv,2016,22.5%,77.5%
3009,Hysteria,9584256,1804139,7780117,2011.csv,2011,18.8%,81.2%
3010,Official Secrets,9581462,1988546,7592916,2019.csv,2019,20.8%,79.2%
3011,The Man Without a Past,9564237,921847,8642390,2002.csv,2002,9.6%,90.4%
3012,God of War,9559524,53000,9506524,2017.csv,2017,0.6%,99.4%
3013,Promare,9548005,2313596,7234409,2019.csv,2019,24.2%,75.8%
3014,Traffik,9515914,9186156,329758,2018.csv,2018,96.5%,3.5%
3015,The Young and Prodigious T.S. Spivet,9494789,173564,9321225,2013.csv,2013,1.8%,98.2%
3016,The Square,9493791,1502347,7991444,2017.csv,2017,15.8%,84.2%
3017,Point Blank,9487445,708215,8779230,2010.csv,2010,7.5%,92.5%
3018,Our Time Will Come,9484714,114560,9370154,2017.csv,2017,1.2%,98.8%
3019,The Mayor 2017 Re-release,9476194,96777,9379417,2017.csv,2017,1%,99%
3020,Peepli (Live),9460931,757951,8702980,2010.csv,2010,8%,92%
3021,Superbabies: Baby Geniuses 2,9448644,9219388,229256,2004.csv,2004,97.6%,2.4%
3022,Veronica Guerin,9439660,1571504,7868156,2003.csv,2003,16.6%,83.4%
3023,The Big Bad Fox and Other Tales 2017 Re-release,9422127,35787,9386340,2017.csv,2017,0.4%,99.6%
3024,Ghost Dog: The Way of the Samurai,9380473,3308029,6072444,2000.csv,2000,35.3%,64.7%
3025,Bel Ami,9374932,120462,9254470,2012.csv,2012,1.3%,98.7%
3026,You Were Never Really Here,9360514,2528078,6832436,2017.csv,2017,27%,73%
3027,Saving Private Perez,9330465,1400726,7929739,2011.csv,2011,15%,85%
3028,Replicas,9330075,4046429,5283646,2018.csv,2018,43.4%,56.6%
3029,The Story of the Weeping Camel,9328652,1763052,7565600,2004.csv,2004,18.9%,81.1%
3030,MacGruber,9322895,8525600,797295,2010.csv,2010,91.4%,8.6%
3031,Peeples,9307166,9177065,130101,2013.csv,2013,98.6%,1.4%
3032,Mad Love,9306362,280046,9026316,2001.csv,2001,3%,97%
3033,Secretary,9304609,4059680,5244929,2002.csv,2002,43.6%,56.4%
3034,Mid90s,9303022,7362439,1940583,2018.csv,2018,79.1%,20.9%
3035,Salaam Namaste,9289939,1413283,7876656,2005.csv,2005,15.2%,84.8%
3036,Jerusalem,9279456,8020721,1258735,2013.csv,2013,86.4%,13.6%
3037,Le Chef,9245235,342667,8902568,2012.csv,2012,3.7%,96.3%
3038,We Need to Talk About Kevin,9232318,1738692,7493626,2011.csv,2011,18.8%,81.2%
3039,The Aftermath,9215591,1618497,7597094,2019.csv,2019,17.6%,82.4%
3040,State and Main,9206279,6944471,2261808,2000.csv,2000,75.4%,24.6%
3041,Tulip Fever,9204549,2455635,6748914,2017.csv,2017,26.7%,73.3%
3042,My Cousin Rachel,9200168,2716368,6483800,2017.csv,2017,29.5%,70.5%
3043,Jexi,9172189,6546159,2626030,2019.csv,2019,71.4%,28.6%
3044,A Hologram for the King,9169507,4212494,4957013,2016.csv,2016,45.9%,54.1%
3045,Unfinished Song,9166865,1702668,7464197,2013.csv,2013,18.6%,81.4%
3046,The Raid: Redemption,9148519,4105187,5043332,2012.csv,2012,44.9%,55.1%
3047,Ruby Sparks,9128263,2540106,6588157,2012.csv,2012,27.8%,72.2%
3048,My Piece of the Pie,9123187,6850,9116337,2011.csv,2011,<0.1%,99.9%
3049,Searching for Sugar Man,9122406,3696196,5426210,2012.csv,2012,40.5%,59.5%
3050,City Of Rock,9118873,312537,8806336,2017.csv,2017,3.4%,96.6%
3051,Human Capital,9113941,158549,8955392,2014.csv,2014,1.7%,98.3%
3052,Miss Sloane,9101546,3500605,5600941,2016.csv,2016,38.5%,61.5%
3053,Meet the Blacks,9097072,9097072,0,2016.csv,2016,100%,-
3054,Tolkien,9090040,4535154,4554886,2019.csv,2019,49.9%,50.1%
3055,Mad Hot Ballroom,9079042,8117961,961081,2005.csv,2005,89.4%,10.6%
3056,Twice Born,9075131,18295,9056836,2012.csv,2012,0.2%,99.8%
3057,Me and Earl and the Dying Girl,9074749,6758416,2316333,2015.csv,2015,74.5%,25.5%
3058,Monsieur Lazhar,9074711,2009517,7065194,2012.csv,2012,22.1%,77.9%
3059,The Fifth Estate,9058564,3255008,5803556,2013.csv,2013,35.9%,64.1%
3060,El Crimen Perfecto (The Perfect Crime),9040997,418843,8622154,2004.csv,2004,4.6%,95.4%
3061,Incarnate,9037058,4799774,4237284,2016.csv,2016,53.1%,46.9%
3062,Like Crazy,9029150,107362,8921788,2016.csv,2016,1.2%,98.8%
3063,Truman,9027600,210840,8816760,2015.csv,2015,2.3%,97.7%
3064,"Two Days, One Night",9016922,1436243,7580679,2014.csv,2014,15.9%,84.1%
3065,Champion,8974547,97472,8877075,2018.csv,2018,1.1%,98.9%
3066,Frances Ha,8955357,4069826,4885531,2013.csv,2013,45.4%,54.6%
3067,The Lobster 2016 Re-release,8952351,8700374,251977,2016.csv,2016,97.2%,2.8%
3068,The Sun Behind the Moon,8914751,1418314,7496437,2001.csv,2001,15.9%,84.1%
3069,Hannah Arendt,8880936,717205,8163731,2013.csv,2013,8.1%,91.9%
3070,Bluebeard,8855737,43144,8812593,2017.csv,2017,0.5%,99.5%
3071,Après Vous,8852763,830292,8022471,2003.csv,2003,9.4%,90.6%
3072,All Together,8835903,43180,8792723,2012.csv,2012,0.5%,99.5%
3073,Morgan,8809407,3915251,4894156,2016.csv,2016,44.4%,55.6%
3074,18 ans après,8785730,25611,8760119,2003.csv,2003,0.3%,99.7%
3075,Captive State,8772812,5958315,2814497,2019.csv,2019,67.9%,32.1%
3076,Son of the Bride,8772695,624757,8147938,2001.csv,2001,7.1%,92.9%
3077,7 Days in Entebbe,8771432,3326885,5444547,2018.csv,2018,37.9%,62.1%
3078,Ghost World,8764007,6217849,2546158,2001.csv,2001,70.9%,29.1%
3079,Marguerite,8754356,506677,8247679,2015.csv,2015,5.8%,94.2%
3080,La folle histoire de Max et Léon,8750678,543,8750135,2016.csv,2016,<0.1%,100%
3081,The Villainess,8737458,27741,8709717,2017.csv,2017,0.3%,99.7%
3082,Code Geass: Lelouch of the Re;Surrection 2019 Re-release,8715612,522805,8192807,2019.csv,2019,6%,94%
3083,Infernal Affairs,8708932,169659,8539273,2002.csv,2002,1.9%,98.1%
3084,The Forsaken,8704851,7288451,1416400,2001.csv,2001,83.7%,16.3%
3085,The Station Agent,8679814,5739376,2940438,2003.csv,2003,66.1%,33.9%
3086,Le Week-End,8652213,2225098,6427115,2013.csv,2013,25.7%,74.3%
3087,The Traitor,8650229,296027,8354202,2019.csv,2019,3.4%,96.6%
3088,Pope Francis: A Man of His Word,8608385,2008385,6600000,2018.csv,2018,23.3%,76.7%
3089,Love Me If You Dare,8561371,553504,8007867,2003.csv,2003,6.5%,93.5%
3090,Willard,8546666,6886089,1660577,2003.csv,2003,80.6%,19.4%
3091,Space Dogs,8530226,14408,8515818,2010.csv,2010,0.2%,99.8%
3092,Our Brand Is Crisis,8527658,7002261,1525397,2015.csv,2015,82.1%,17.9%
3093,Before Night Falls,8527517,4242892,4284625,2000.csv,2000,49.8%,50.2%
3094,What If,8526288,3493000,5033288,2014.csv,2014,41%,59%
3095,Stronger,8503658,4211129,4292529,2017.csv,2017,49.5%,50.5%
3096,Big Trouble,8493890,7267307,1226583,2002.csv,2002,85.6%,14.4%
3097,Piranha 3DD,8493728,376512,8117216,2012.csv,2012,4.4%,95.6%
3098,La mujer de mi hermano,8492178,2808241,5683937,2005.csv,2005,33.1%,66.9%
3099,Sorry We Missed You,8487343,28273,8459070,2019.csv,2019,0.3%,99.7%
3100,Star Wars: Episode II - Attack of the Clones 2002 IMAX Release,8485488,8485488,0,2002.csv,2002,100%,-
3101,Stay,8483797,3626883,4856914,2005.csv,2005,42.8%,57.2%
3102,Amityville: The Awakening,8481997,742,8481255,2017.csv,2017,<0.1%,100%
3103,A-X-L,8467697,6501381,1966316,2018.csv,2018,76.8%,23.2%
3104,The Outrage,8457741,44745,8412996,2010.csv,2010,0.5%,99.5%
3105,Beyond the Sea,8447615,6318709,2128906,2004.csv,2004,74.8%,25.2%
3106,Casa de mi Padre,8446952,5909483,2537469,2012.csv,2012,70%,30%
3107,A Street Cat Named Bob,8446262,82703,8363559,2016.csv,2016,1%,99%
3108,Princesas,8446185,29472,8416713,2005.csv,2005,0.3%,99.7%
3109,The Way 2010 Re-release,8437872,4430765,4007107,2010.csv,2010,52.5%,47.5%
3110,Condorito: The Movie,8431194,447719,7983475,2017.csv,2017,5.3%,94.7%
3111,Raees,8428190,3262954,5165236,2017.csv,2017,38.7%,61.3%
3112,Amen.,8419052,274299,8144753,2002.csv,2002,3.3%,96.7%
3113,Go for Zucker,8394115,87490,8306625,2005.csv,2005,1%,99%
3114,Death to Smoochy,8382938,8364691,18247,2002.csv,2002,99.8%,0.2%
3115,Bones,8378853,7316658,1062195,2001.csv,2001,87.3%,12.7%
3116,Filth,8377987,34411,8343576,2013.csv,2013,0.4%,99.6%
3117,Snabba Cash,8369756,205741,8164015,2010.csv,2010,2.5%,97.5%
3118,The Love Punch,8366493,266588,8099905,2014.csv,2014,3.2%,96.8%
3119,Venus in Fur,8350026,373605,7976421,2013.csv,2013,4.5%,95.5%
3120,I Am Not Your Negro,8345298,7123919,1221379,2017.csv,2017,85.4%,14.6%
3121,Time Renegades,8312361,59425,8252936,2016.csv,2016,0.7%,99.3%
3122,London Boulevard,8307227,16075,8291152,2010.csv,2010,0.2%,99.8%
3123,Design for Living,8290521,63675,8226846,2015.csv,2015,0.8%,99.2%
3124,My Worst Nightmare,8226544,21952,8204592,2011.csv,2011,0.3%,99.7%
3125,It Runs in the Family,8211508,7491839,719669,2003.csv,2003,91.2%,8.8%
3126,The Machinist,8203235,1082715,7120520,2004.csv,2004,13.2%,86.8%
3127,Santa vs. the Snowman 3D,8198286,1934053,6264233,2002.csv,2002,23.6%,76.4%
3128,Cave of Forgotten Dreams,8183347,5304920,2878427,2011.csv,2011,64.8%,35.2%
3129,The Big Year,8179416,7204138,975278,2011.csv,2011,88.1%,11.9%
3130,The Edukators,8152859,175493,7977366,2004.csv,2004,2.2%,97.8%
3131,Impostor,8145549,6285176,1860373,2002.csv,2002,77.2%,22.8%
3132,Mangal Pandey: The Rising,8142076,954108,7187968,2005.csv,2005,11.7%,88.3%
3133,Walk of Shame,8122990,59209,8063781,2014.csv,2014,0.7%,99.3%
3134,Spartan,8112712,4434432,3678280,2004.csv,2004,54.7%,45.3%
3135,Ernest & Celestine,8111137,262075,7849062,2012.csv,2012,3.2%,96.8%
3136,The New Year's Eve of Old Lee,8099301,25358,8073943,2016.csv,2016,0.3%,99.7%
3137,The Man Who Invented Christmas,8096007,5676486,2419521,2017.csv,2017,70.1%,29.9%
3138,The Company Men,8087000,4441272,3645728,2011.csv,2011,54.9%,45.1%
3139,The Hidden Blade,8043781,38147,8005634,2004.csv,2004,0.5%,99.5%
3140,Heroine,8036853,598668,7438185,2012.csv,2012,7.4%,92.6%
3141,Me and You and Everyone We Know,8012838,3885134,4127704,2005.csv,2005,48.5%,51.5%
3142,My King,8003331,54114,7949217,2015.csv,2015,0.7%,99.3%
3143,Disobedience,8003180,3498782,4504398,2018.csv,2018,43.7%,56.3%
3144,Life Itself,7997774,4102648,3895126,2018.csv,2018,51.3%,48.7%
3145,Denial,7994527,4073489,3921038,2016.csv,2016,51%,49%
3146,American Splendor,7986084,6010990,1975094,2003.csv,2003,75.3%,24.7%
3147,The Battle of Jangsari,7976445,70853,7905592,2019.csv,2019,0.9%,99.1%
3148,Metallica Through the Never,7975812,3419967,4555845,2013.csv,2013,42.9%,57.1%
3149,Merci pour le Chocolat,7972251,443238,7529013,2002.csv,2002,5.6%,94.4%
3150,Fanfan,7949963,32686,7917277,2003.csv,2003,0.4%,99.6%
3151,Chasing Mavericks,7942116,6002756,1939360,2012.csv,2012,75.6%,24.4%
3152,Suspiria,7942093,2483472,5458621,2018.csv,2018,31.3%,68.7%
3153,Coffee and Cigarettes,7929307,2198924,5730383,2004.csv,2004,27.7%,72.3%
3154,The Ark of Mr Chow,7894075,54075,7840000,2015.csv,2015,0.7%,99.3%
3155,Baghban,7885479,1058803,6826676,2003.csv,2003,13.4%,86.6%
3156,Pavarotti,7885016,4600249,3284767,2019.csv,2019,58.3%,41.7%
3157,Inside Job,7871522,4312735,3558787,2010.csv,2010,54.8%,45.2%
3158,For a Few Bullets,7860447,30142,7830305,2016.csv,2016,0.4%,99.6%
3159,Salut d'Amour,7858183,22480,7835703,2015.csv,2015,0.3%,99.7%
3160,Pele: Birth of a Legend,7846608,57046,7789562,2016.csv,2016,0.7%,99.3%
3161,The Lady,7832142,355391,7476751,2011.csv,2011,4.5%,95.5%
3162,Renoir,7816573,2293798,5522775,2013.csv,2013,29.3%,70.7%
3163,Dongju: The Portrait of a Poet,7809531,56550,7752981,2016.csv,2016,0.7%,99.3%
3164,Tupac: Resurrection,7808524,7718961,89563,2003.csv,2003,98.9%,1.1%
3165,Qué León,7807916,2607916,5200000,2018.csv,2018,33.4%,66.6%
3166,Bad Words,7804337,7779614,24723,2014.csv,2014,99.7%,0.3%
3167,Amazing Grace,7796112,4450456,3345656,2018.csv,2018,57.1%,42.9%
3168,Real Women Have Curves,7777790,5853194,1924596,2002.csv,2002,75.3%,24.7%
3169,By the Grace of God,7755652,67059,7688593,2019.csv,2019,0.9%,99.1%
3170,3 idiotas,7738470,1249233,6489237,2017.csv,2017,16.1%,83.9%
3171,Certified Copy,7736632,1373975,6362657,2010.csv,2010,17.8%,82.2%
3172,Butterfly,7733894,2092682,5641212,2000.csv,2000,27.1%,72.9%
3173,Love Live! Sunshine!! The School Idol Movie: Over The Rainbow,7733048,34135,7698913,2019.csv,2019,0.4%,99.6%
3174,Explosion,7731410,122700,7608710,2017.csv,2017,1.6%,98.4%
3175,Cedar Rapids,7728936,6861102,867834,2011.csv,2011,88.8%,11.2%
3176,Mia Madre,7723656,303002,7420654,2015.csv,2015,3.9%,96.1%
3177,The Sweeney,7708312,26650,7681662,2012.csv,2012,0.3%,99.7%
3178,Kevin Hart: Laugh at My Pain,7706436,7706436,0,2011.csv,2011,100%,-
3179,BPM (Beats Per Minute),7704369,125189,7579180,2017.csv,2017,1.6%,98.4%
3180,Penguins,7699452,7699452,0,2019.csv,2019,100%,-
3181,No,7699095,2343664,5355431,2012.csv,2012,30.4%,69.6%
3182,Declaration of War,7691610,59100,7632510,2011.csv,2011,0.8%,99.2%
3183,Finding Fanny,7685784,615691,7070093,2014.csv,2014,8%,92%
3184,Leave No Trace,7682928,6046104,1636824,2018.csv,2018,78.7%,21.3%
3185,Lolo,7663798,24134,7639664,2015.csv,2015,0.3%,99.7%
3186,Steal,7662206,220944,7441262,2002.csv,2002,2.9%,97.1%
3187,Sex and Lucía,7640680,1594779,6045901,2001.csv,2001,20.9%,79.1%
3188,Pandas,7635778,7574012,61766,2018.csv,2018,99.2%,0.8%
3189,Just Getting Started,7634022,6069605,1564417,2017.csv,2017,79.5%,20.5%
3190,The White Crow,7622595,1828784,5793811,2019.csv,2019,24%,76%
3191,Monkeybone,7622365,5411999,2210366,2001.csv,2001,71%,29%
3192,Fullmetal Alchemist: The Sacred Star of Milos,7621364,177802,7443562,2011.csv,2011,2.3%,97.7%
3193,Only Lovers Left Alive,7609187,1879534,5729653,2013.csv,2013,24.7%,75.3%
3194,The Flower of Evil,7587959,182163,7405796,2003.csv,2003,2.4%,97.6%
3195,Man on the Train,7585989,2542020,5043969,2002.csv,2002,33.5%,66.5%
3196,Klovn Forever,7585569,5700,7579869,2015.csv,2015,<0.1%,99.9%
3197,Miss You Already,7573997,1162653,6411344,2015.csv,2015,15.4%,84.6%
3198,Burning,7566962,718991,6847971,2018.csv,2018,9.5%,90.5%
3199,Club Dread,7565807,5001708,2564099,2004.csv,2004,66.1%,33.9%
3200,Hippocrates: Diary of a French Doctor,7555591,23050,7532541,2014.csv,2014,0.3%,99.7%
3201,"Kiki, Love to Love",7551282,12450,7538832,2016.csv,2016,0.2%,99.8%
3202,The Advocate: A Missing Body,7550177,50162,7500015,2015.csv,2015,0.7%,99.3%
3203,Take Me Home Tonight,7550073,6928068,622005,2011.csv,2011,91.8%,8.2%
3204,A Bigger Splash,7545758,2024099,5521659,2015.csv,2015,26.8%,73.2%
3205,Albert Nobbs,7532259,3014696,4517563,2011.csv,2011,40%,60%
3206,Beirut,7509436,5019226,2490210,2018.csv,2018,66.8%,33.2%
3207,Where Do We Go Now?,7507008,531997,6975011,2011.csv,2011,7.1%,92.9%
3208,Open Season 3,7487555,0,7487555,2010.csv,2010,-,100%
3209,Frantz,7478354,880883,6597471,2016.csv,2016,11.8%,88.2%
3210,The Tall Man,7462847,0,7462847,2012.csv,2012,-,100%
3211,Spellbound,7457710,5728581,1729129,2003.csv,2003,76.8%,23.2%
3212,Big Game,7455398,24752,7430646,2015.csv,2015,0.3%,99.7%
3213,Black Nativity,7454185,7018189,435996,2013.csv,2013,94.2%,5.8%
3214,I'll See You in My Dreams,7452512,7449681,2831,2015.csv,2015,100%,<0.1%
3215,Yu-Gi-Oh!: The Dark Side of Dimensions,7445186,1015339,6429847,2016.csv,2016,13.6%,86.4%
3216,5x2,7444906,128752,7316154,2004.csv,2004,1.7%,98.3%
3217,Brittany Runs a Marathon,7442106,7189808,252298,2019.csv,2019,96.6%,3.4%
3218,Mayday Life,7435496,85912,7349584,2019.csv,2019,1.2%,98.8%
3219,Genius,7435006,1361045,6073961,2016.csv,2016,18.3%,81.7%
3220,Beatriz at Dinner,7425391,7115854,309537,2017.csv,2017,95.8%,4.2%
3221,God's Not Dead: A Light in Darkness,7414178,5728940,1685238,2018.csv,2018,77.3%,22.7%
3222,Goodbye Christopher Robin,7401949,1735251,5666698,2017.csv,2017,23.4%,76.6%
3223,The Innocents,7400324,1065665,6334659,2016.csv,2016,14.4%,85.6%
3224,Requiem for a Dream,7390108,3635482,3754626,2000.csv,2000,49.2%,50.8%
3225,Return of the Hero,7362730,37108,7325622,2018.csv,2018,0.5%,99.5%
3226,I'm Not Scared,7354418,1615328,5739090,2003.csv,2003,22%,78%
3227,Compadres,7353544,3127773,4225771,2016.csv,2016,42.5%,57.5%
3228,The Young Messiah,7330338,6490401,839937,2016.csv,2016,88.5%,11.5%
3229,Even the Rain,7313485,518017,6795468,2011.csv,2011,7.1%,92.9%
3230,Dhoom,7312209,245756,7066453,2004.csv,2004,3.4%,96.6%
3231,Mean Machine,7310206,92770,7217436,2001.csv,2001,1.3%,98.7%
3232,Respiro,7309845,1072834,6237011,2002.csv,2002,14.7%,85.3%
3233,The Beaver,7294800,970816,6323984,2011.csv,2011,13.3%,86.7%
3234,The Midwife,7286136,603582,6682554,2017.csv,2017,8.3%,91.7%
3235,Gigli,7266209,6087542,1178667,2003.csv,2003,83.8%,16.2%
3236,A Long Way Down,7257942,13347,7244595,2014.csv,2014,0.2%,99.8%
3237,Where the Money Is,7243669,5661798,1581871,2000.csv,2000,78.2%,21.8%
3238,Let There Be Light,7233471,7233471,0,2017.csv,2017,100%,-
3239,Birth of the Dragon,7215027,6901965,313062,2017.csv,2017,95.7%,4.3%
3240,20th Century Women,7214806,5664764,1550042,2016.csv,2016,78.5%,21.5%
3241,Animal Kingdom,7208231,1044039,6164192,2010.csv,2010,14.5%,85.5%
3242,Grandma,7205073,6980524,224549,2015.csv,2015,96.9%,3.1%
3243,Screwed,7201701,7027345,174356,2000.csv,2000,97.6%,2.4%
3244,The Widow of Saint-Pierre,7193889,3193889,4000000,2000.csv,2000,44.4%,55.6%
3245,Timbuktu,7179391,1076075,6103316,2014.csv,2014,15%,85%
3246,Blade of the Immortal,7162617,150532,7012085,2017.csv,2017,2.1%,97.9%
3247,Wild Rose,7123449,1635117,5488332,2019.csv,2019,23%,77%
3248,Jet Lag,7121171,250000,6871171,2002.csv,2002,3.5%,96.5%
3249,The Adventures of Pluto Nash,7103973,4420080,2683893,2002.csv,2002,62.2%,37.8%
3250,Postman Pat,7102455,1519,7100936,2014.csv,2014,<0.1%,100%
3251,Incendies,7099598,2071334,5028264,2011.csv,2011,29.2%,70.8%
3252,The Truth About Charlie,7093284,5350371,1742913,2002.csv,2002,75.4%,24.6%
3253,In Safe Hands,7086596,1737,7084859,2018.csv,2018,<0.1%,100%
3254,Croupier,7075068,6201143,873925,2000.csv,2000,87.6%,12.4%
3255,Gosanja: Dae-dong-yeo Ji-do,7035812,34034,7001778,2016.csv,2016,0.5%,99.5%
3256,The Joneses,7031729,1475746,5555983,2010.csv,2010,21%,79%
3257,Cosmopolis,7029095,763556,6265539,2012.csv,2012,10.9%,89.1%
3258,The Killing of a Sacred Deer,7027336,2291901,4735435,2017.csv,2017,32.6%,67.4%
3259,Innocent Voices,7015131,837878,6177253,2005.csv,2005,11.9%,88.1%
3260,The Kid with a Bike,7011798,1470000,5541798,2011.csv,2011,21%,79%
3261,Jessabelle,6998359,0,6998359,2014.csv,2014,-,100%
3262,Goon,6985158,4168528,2816630,2012.csv,2012,59.7%,40.3%
3263,What We Do in the Shadows,6979001,3469224,3509777,2014.csv,2014,49.7%,50.3%
3264,The Princess of Montpensier,6965201,352428,6612773,2010.csv,2010,5.1%,94.9%
3265,11-11-11,6963872,32771,6931101,2011.csv,2011,0.5%,99.5%
3266,"Spring, Summer, Fall, Winter... and Spring",6959791,2380788,4579003,2003.csv,2003,34.2%,65.8%
3267,The Salesman,6953604,2402067,4551537,2016.csv,2016,34.5%,65.5%
3268,Santa vs. the Snowman 3D 2003 Re-release,6952764,3045032,3907732,2003.csv,2003,43.8%,56.2%
3269,Father and Sons,6935839,634968,6300871,2003.csv,2003,9.2%,90.8%
3270,Igby Goes Down,6919198,4777465,2141733,2002.csv,2002,69%,31%
3271,The Spectacular Now,6918591,6854611,63980,2013.csv,2013,99.1%,0.9%
3272,Don 2,6913518,3680306,3233212,2011.csv,2011,53.2%,46.8%
3273,Painted Fire,6906235,64029,6842206,2002.csv,2002,0.9%,99.1%
3274,Centurion,6890432,123570,6766862,2010.csv,2010,1.8%,98.2%
3275,Barbara,6889185,1013902,5875283,2012.csv,2012,14.7%,85.3%
3276,Veer-Zaara,6887221,2938532,3948689,2004.csv,2004,42.7%,57.3%
3277,Woman Thou Art Loosed,6879730,6879730,0,2004.csv,2004,100%,-
3278,The Awakening,6879667,209696,6669971,2011.csv,2011,3%,97%
3279,Talvar,6879098,342370,6536728,2015.csv,2015,5%,95%
3280,A Good Woman,6878433,238609,6639824,2005.csv,2005,3.5%,96.5%
3281,Last Orders,6873892,2329631,4544261,2002.csv,2002,33.9%,66.1%
3282,Bee Season,6856989,1180560,5676429,2005.csv,2005,17.2%,82.8%
3283,Commitment,6834802,76543,6758259,2013.csv,2013,1.1%,98.9%
3284,Dog Days,6819044,6809080,9964,2018.csv,2018,99.9%,0.1%
3285,Collide,6817535,2280004,4537531,2016.csv,2016,33.4%,66.6%
3286,Race 3,6817391,1690861,5126530,2018.csv,2018,24.8%,75.2%
3287,Bran Nue Dae,6812530,113568,6698962,2010.csv,2010,1.7%,98.3%
3288,The Aristocrats,6809089,6377461,431628,2005.csv,2005,93.7%,6.3%
3289,The Big Bounce,6808550,6489476,319074,2004.csv,2004,95.3%,4.7%
3290,The Names of Love,6803887,514237,6289650,2010.csv,2010,7.6%,92.4%
3291,Baahubali,6787855,6738000,49855,2015.csv,2015,99.3%,0.7%
3292,China: The Panda Adventure,6784985,3921642,2863343,2001.csv,2001,57.8%,42.2%
3293,The Road Home,6780490,1280490,5500000,2001.csv,2001,18.9%,81.1%
3294,A Little Bit of Heaven,6778388,15375,6763013,2011.csv,2011,0.2%,99.8%
3295,The Sun Is Also a Star,6750029,4950029,1800000,2019.csv,2019,73.3%,26.7%
3296,The Piano Teacher,6749315,1012069,5737246,2001.csv,2001,15%,85%
3297,Séraphin: un homme et son péché,6749187,6749187,0,2002.csv,2002,100%,-
3298,A Letter to Momo,6748888,71712,6677176,2012.csv,2012,1.1%,98.9%
3299,R-Point,6744984,0,6744984,2004.csv,2004,-,100%
3300,Midnight Special,6740647,3712282,3028365,2016.csv,2016,55.1%,44.9%
3301,Wild Card,6738764,0,6738764,2015.csv,2015,-,100%
3302,Churchill,6724365,1281258,5443107,2017.csv,2017,19.1%,80.9%
3303,Cesar Chavez 2014 Re-release,6719925,5571497,1148428,2014.csv,2014,82.9%,17.1%
3304,The Door in the Floor,6715067,3854624,2860443,2004.csv,2004,57.4%,42.6%
3305,Jab Tak Hai Jaan,6703114,3047539,3655575,2012.csv,2012,45.5%,54.5%
3306,Bleed for This,6698679,5083906,1614773,2016.csv,2016,75.9%,24.1%
3307,Fragile,6680926,0,6680926,2005.csv,2005,-,100%
3308,Fahrenheit 11/9,6674168,6352306,321862,2018.csv,2018,95.2%,4.8%
3309,Son of Saul,6659121,1777043,4882078,2015.csv,2015,26.7%,73.3%
3310,The Conquest,6637166,74474,6562692,2011.csv,2011,1.1%,98.9%
3311,Spider-Man/Men in Black II,6632970,6632970,0,2002.csv,2002,100%,-
3312,Southside with You,6628603,6304223,324380,2016.csv,2016,95.1%,4.9%
3313,Duets,6620242,4739023,1881219,2000.csv,2000,71.6%,28.4%
3314,Pieta,6616296,22080,6594216,2012.csv,2012,0.3%,99.7%
3315,Against the Ropes,6596511,5884190,712321,2004.csv,2004,89.2%,10.8%
3316,The Red Turtle,6591789,921974,5669815,2016.csv,2016,14%,86%
3317,Mambo Italiano 2003 Re-release,6590962,3205730,3385232,2003.csv,2003,48.6%,51.4%
3318,I Capture the Castle,6586341,1179035,5407306,2003.csv,2003,17.9%,82.1%
3319,Ned Kelly,6585516,86959,6498557,2003.csv,2003,1.3%,98.7%
3320,Soorma,6579645,390077,6189568,2018.csv,2018,5.9%,94.1%
3321,The Raid 2,6566916,2627209,3939707,2014.csv,2014,40%,60%
3322,A Melody to Remember,6559996,44263,6515733,2016.csv,2016,0.7%,99.3%
3323,Ae Fond Kiss,6547641,30148,6517493,2004.csv,2004,0.5%,99.5%
3324,National Theatre Live: Fleabag,6538919,326283,6212636,2019.csv,2019,5%,95%
3325,Bon voyage,6536601,148727,6387874,2003.csv,2003,2.3%,97.7%
3326,Under the Sand,6531687,1452698,5078989,2001.csv,2001,22.2%,77.8%
3327,From the Land of the Moon 2016 Re-release,6524799,47748,6477051,2016.csv,2016,0.7%,99.3%
3328,The Measure of a Man,6518931,112391,6406540,2015.csv,2015,1.7%,98.3%
3329,The Hunt,6512500,5812500,700000,2020.csv,2020,89.3%,10.7%
3330,The Lobster,6504366,376871,6127495,2015.csv,2015,5.8%,94.2%
3331,Wadjda,6499169,1347747,5151422,2012.csv,2012,20.7%,79.3%
3332,Teacher's Pet,6491969,6491969,0,2004.csv,2004,100%,-
3333,It's Kind of a Funny Story,6491240,6363628,127612,2010.csv,2010,98%,2%
3334,Everybody Loves Somebody,6481798,1915789,4566009,2017.csv,2017,29.6%,70.4%
3335,Irreversible,6479328,792200,5687128,2002.csv,2002,12.2%,87.8%
3336,Gloria,6461559,2107925,4353634,2013.csv,2013,32.6%,67.4%
3337,The Devil's Backbone,6459020,755249,5703771,2001.csv,2001,11.7%,88.3%
3338,Lassie,6442854,652163,5790691,2005.csv,2005,10.1%,89.9%
3339,Waiting for 'Superman',6433688,6417135,16553,2010.csv,2010,99.7%,0.3%
3340,Run the Race,6424420,6424420,0,2019.csv,2019,100%,-
3341,Same Kind of Different as Me,6423605,6423605,0,2017.csv,2017,100%,-
3342,Eye See You,6416302,79161,6337141,2002.csv,2002,1.2%,98.8%
3343,Slackers,6413915,5285941,1127974,2002.csv,2002,82.4%,17.6%
3344,Gotti,6412349,4343227,2069122,2018.csv,2018,67.7%,32.3%
3345,The Secret Life of Words,6410058,20678,6389380,2005.csv,2005,0.3%,99.7%
3346,The Mustang,6405816,5043620,1362196,2019.csv,2019,78.7%,21.3%
3347,The Company,6401690,2283914,4117776,2003.csv,2003,35.7%,64.3%
3348,A Journey Through Time with Antony,6389648,127381,6262267,2015.csv,2015,2%,98%
3349,"Farewell, My Queen",6366835,1597998,4768837,2012.csv,2012,25.1%,74.9%
3350,The Chorus 2005 Re-release,6353810,1548036,4805774,2005.csv,2005,24.4%,75.6%
3351,Greenberg,6344112,4234170,2109942,2010.csv,2010,66.7%,33.3%
3352,Hector and the Search for Happiness,6337728,1124445,5213283,2014.csv,2014,17.7%,82.3%
3353,Hampstead,6335171,144396,6190775,2017.csv,2017,2.3%,97.7%
3354,Closed Circuit,6331939,5750401,581538,2013.csv,2013,90.8%,9.2%
3355,Sheng zhe wei wang,6313827,163406,6150421,2015.csv,2015,2.6%,97.4%
3356,Lowriders,6312033,6303560,8473,2017.csv,2017,99.9%,0.1%
3357,Absolutely Anything,6303792,20169,6283623,2015.csv,2015,0.3%,99.7%
3358,A Late Quartet,6303709,1562548,4741161,2012.csv,2012,24.8%,75.2%
3359,Las Pildoras De Mi Novio,6292780,2971116,3321664,2020.csv,2020,47.2%,52.8%
3360,High Tension,6291958,3681066,2610892,2003.csv,2003,58.5%,41.5%
3361,Main Prem Ki Diwani Hoon,6290342,1232228,5058114,2003.csv,2003,19.6%,80.4%
3362,Deuces Wild,6282446,6080065,202381,2002.csv,2002,96.8%,3.2%
3363,Max Steel,6272403,3818664,2453739,2016.csv,2016,60.9%,39.1%
3364,Norman,6217567,3814868,2402699,2017.csv,2017,61.4%,38.6%
3365,Unbroken: Path to Redemption,6216897,6216897,0,2018.csv,2018,100%,-
3366,Attack the Block,6206022,1024175,5181847,2011.csv,2011,16.5%,83.5%
3367,Happily Ever After,6204504,252379,5952125,2005.csv,2005,4.1%,95.9%
3368,Great Expectations,6202879,258656,5944223,2012.csv,2012,4.2%,95.8%
3369,The Snitch Cartel,6197324,0,6197324,2012.csv,2012,-,100%
3370,Yeh Jawaani Hai Deewani,6189998,3827466,2362532,2013.csv,2013,61.8%,38.2%
3371,Immortal Hero,6180032,43007,6137025,2019.csv,2019,0.7%,99.3%
3372,The Autopsy of Jane Doe,6170043,10474,6159569,2016.csv,2016,0.2%,99.8%
3373,Tiger & Bunny: The Rising,6168617,34471,6134146,2014.csv,2014,0.6%,99.4%
3374,The Professor and the Madman,6162010,0,6162010,2019.csv,2019,-,100%
3375,Darker Than Night,6160114,870063,5290051,2014.csv,2014,14.1%,85.9%
3376,The Patriarch,6156936,2156047,4000889,2016.csv,2016,35%,65%
3377,Four Lions,6148687,304616,5844071,2010.csv,2010,5%,95%
3378,Ploey,6146292,77815,6068477,2018.csv,2018,1.3%,98.7%
3379,Mobile Suit Gundam Narrative,6126259,259224,5867035,2018.csv,2018,4.2%,95.8%
3380,Warriors of Heaven and Earth,6106178,82936,6023242,2003.csv,2003,1.4%,98.6%
3381,The Duelist,6101904,13450,6088454,2016.csv,2016,0.2%,99.8%
3382,The Trip to Italy,6089109,2880537,3208572,2014.csv,2014,47.3%,52.7%
3383,Rosenstrasse,6075609,734519,5341090,2003.csv,2003,12.1%,87.9%
3384,Megiddo: The Omega Code 2,6047691,6047691,0,2001.csv,2001,100%,-
3385,Meet the Mormons,6047363,6047363,0,2014.csv,2014,100%,-
3386,She's Funny That Way,6034851,111996,5922855,2015.csv,2015,1.9%,98.1%
3387,East/West,6031521,2321029,3710492,2000.csv,2000,38.5%,61.5%
3388,Matru ki Bijlee ka Mandola,6009116,0,6009116,2013.csv,2013,-,100%
3389,The Illusionist,6007194,2231474,3775720,2010.csv,2010,37.1%,62.9%
3390,Russian Ark,6001714,2326979,3674735,2002.csv,2002,38.8%,61.2%
3391,Blue Exorcist: The Movie,5994921,21796,5973125,2012.csv,2012,0.4%,99.6%
3392,The Broken Circle Breakdown,5990754,175058,5815696,2012.csv,2012,2.9%,97.1%
3393,The Rhythm Section,5989583,5437971,551612,2020.csv,2020,90.8%,9.2%
3394,The Butterfly,5983780,189144,5794636,2002.csv,2002,3.2%,96.8%
3395,"Cyrano, My Love",5982358,351019,5631339,2019.csv,2019,5.9%,94.1%
3396,Learning to Drive,5967516,3447633,2519883,2015.csv,2015,57.8%,42.2%
3397,The Immigrant,5952884,2025328,3927556,2013.csv,2013,34%,66%
3398,Chalte Chalte,5945422,836225,5109197,2003.csv,2003,14.1%,85.9%
3399,All Saints,5942565,5802208,140357,2017.csv,2017,97.6%,2.4%
3400,Don't Tell,5923415,29015,5894400,2005.csv,2005,0.5%,99.5%
3401,Never Die Alone,5923000,5645298,277702,2004.csv,2004,95.3%,4.7%
3402,Callas Forever,5906353,446955,5459398,2002.csv,2002,7.6%,92.4%
3403,Death of a Nation,5885881,5885881,0,2018.csv,2018,100%,-
3404,Maggie's Plan,5883891,3351735,2532156,2016.csv,2016,57%,43%
3405,Underclassman,5879555,5655459,224096,2005.csv,2005,96.2%,3.8%
3406,Testament of Youth,5874883,1822250,4052633,2015.csv,2015,31%,69%
3407,My Life as a Zucchini,5872598,309766,5562832,2016.csv,2016,5.3%,94.7%
3408,Lakshya,5859242,753600,5105642,2004.csv,2004,12.9%,87.1%
3409,Tracks,5853509,510007,5343502,2014.csv,2014,8.7%,91.3%
3410,20 Feet from Stardom,5839368,4946445,892923,2013.csv,2013,84.7%,15.3%
3411,The Hero: Love Story of a Spy,5835846,285394,5550452,2003.csv,2003,4.9%,95.1%
3412,Young Goethe in Love,5826565,162138,5664427,2010.csv,2010,2.8%,97.2%
3413,Puella Magi Madoka Magica the Movie Part 1: Beginnings,5816330,180440,5635890,2012.csv,2012,3.1%,96.9%
3414,Spider,5808941,1642483,4166458,2002.csv,2002,28.3%,71.7%
3415,Phillauri,5805030,467596,5337434,2017.csv,2017,8.1%,91.9%
3416,Strange Gardens,5793539,78668,5714871,2003.csv,2003,1.4%,98.6%
3417,Phoenix,5793245,3184472,2608773,2014.csv,2014,55%,45%
3418,The Wizard of Oz 2013 3D/IMAX Release,5787802,5633202,154600,2013.csv,2013,97.3%,2.7%
3419,Dylan Dog: Dead of Night,5782515,1186538,4595977,2011.csv,2011,20.5%,79.5%
3420,The Skeleton Twins,5776640,5284309,492331,2014.csv,2014,91.5%,8.5%
3421,Untold Scandal,5762801,63332,5699469,2004.csv,2004,1.1%,98.9%
3422,The Good Thief,5756945,3517797,2239148,2003.csv,2003,61.1%,38.9%
3423,Kaante,5753991,1041228,4712763,2002.csv,2002,18.1%,81.9%
3424,The Golden Bowl,5753678,3050532,2703146,2001.csv,2001,53%,47%
3425,Nicotina,5751007,1117864,4633143,2003.csv,2003,19.4%,80.6%
3426,The Disappointments Room,5745040,2423468,3321572,2016.csv,2016,42.2%,57.8%
3427,Under the Skin,5735963,2614251,3121712,2014.csv,2014,45.6%,54.4%
3428,The Devil's Double,5728213,1361512,4366701,2011.csv,2011,23.8%,76.2%
3429,Kingsglaive: Final Fantasy XV,5725482,269980,5455502,2016.csv,2016,4.7%,95.3%
3430,Furie,5717640,594788,5122852,2019.csv,2019,10.4%,89.6%
3431,Like for Likes,5715555,50839,5664716,2016.csv,2016,0.9%,99.1%
3432,Saaho,5708522,2872057,2836465,2019.csv,2019,50.3%,49.7%
3433,My Best Friend's Wedding,5707770,78578,5629192,2016.csv,2016,1.4%,98.6%
3434,The Viral Factor,5687319,220496,5466823,2012.csv,2012,3.9%,96.1%
3435,Wish I Was Here,5670776,3591299,2079477,2014.csv,2014,63.3%,36.7%
3436,Mission Mangal,5667057,3659413,2007644,2019.csv,2019,64.6%,35.4%
3437,Anomalisa,5659286,3759286,1900000,2015.csv,2015,66.4%,33.6%
3438,Incident in a Ghostland,5643957,0,5643957,2018.csv,2018,-,100%
3439,Things to Come,5638693,388140,5250553,2016.csv,2016,6.9%,93.1%
3440,Wazir,5633588,1124045,4509543,2016.csv,2016,20%,80%
3441,Dalida,5623134,3465,5619669,2017.csv,2017,<0.1%,99.9%
3442,Mother and Child,5621971,1110509,4511462,2010.csv,2010,19.8%,80.2%
3443,Solitary Man,5615390,4360548,1254842,2010.csv,2010,77.7%,22.3%
3444,El Angel,5604680,109608,5495072,2018.csv,2018,2%,98%
3445,The Party,5597950,749827,4848123,2017.csv,2017,13.4%,86.6%
3446,A Fish Tale,5595327,563911,5031416,2001.csv,2001,10.1%,89.9%
3447,Fathers & Daughters,5587709,0,5587709,2015.csv,2015,-,100%
3448,The French Minister,5586646,12027,5574619,2013.csv,2013,0.2%,99.8%
3449,Destroyer,5580940,1533324,4047616,2018.csv,2018,27.5%,72.5%
3450,Pawn Sacrifice,5578519,2436633,3141886,2014.csv,2014,43.7%,56.3%
3451,Knock Knock,5567103,36336,5530767,2015.csv,2015,0.7%,99.3%
3452,Dheepan,5562575,261819,5300756,2014.csv,2014,4.7%,95.3%
3453,Escobar: Paradise Lost,5552496,195792,5356704,2014.csv,2014,3.5%,96.5%
3454,Ek Tha Tiger,5543117,2347774,3195343,2012.csv,2012,42.4%,57.6%
3455,Last Cab to Darwin,5543036,34193,5508843,2015.csv,2015,0.6%,99.4%
3456,Black & White,5541431,5277299,264132,2000.csv,2000,95.2%,4.8%
3457,The Child,5507396,651941,4855455,2005.csv,2005,11.8%,88.2%
3458,On My Way,5505705,317324,5188381,2013.csv,2013,5.8%,94.2%
3459,Warriors of the Dawn,5497176,84532,5412644,2017.csv,2017,1.5%,98.5%
3460,Tale of Tales,5497104,118925,5378179,2015.csv,2015,2.2%,97.8%
3461,A Wizard's Tale,5487261,2150,5485111,2018.csv,2018,<0.1%,100%
3462,People I Know,5484302,126793,5357509,2002.csv,2002,2.3%,97.7%
3463,Made,5480653,5313300,167353,2001.csv,2001,96.9%,3.1%
3464,Chalet Girl,5468650,1710,5466940,2011.csv,2011,<0.1%,100%
3465,Man of Tai Chi,5464885,100144,5364741,2013.csv,2013,1.8%,98.2%
3466,Thank You,5452347,463540,4988807,2011.csv,2011,8.5%,91.5%
3467,OK Jaanu,5445281,355922,5089359,2017.csv,2017,6.5%,93.5%
3468,Hara-Kiri: Death of a Samurai,5435358,75688,5359670,2011.csv,2011,1.4%,98.6%
3469,An Inconvenient Sequel: Truth to Power,5433926,3496795,1937131,2017.csv,2017,64.4%,35.6%
3470,Devdas,5427830,2745382,2682448,2002.csv,2002,50.6%,49.4%
3471,The Salt of the Earth,5412189,1343349,4068840,2014.csv,2014,24.8%,75.2%
3472,The Student and Mister Henri,5411932,761,5411171,2015.csv,2015,<0.1%,100%
3473,Dolls,5405725,4067,5401658,2002.csv,2002,<0.1%,99.9%
3474,Lady Macbeth,5401447,1129408,4272039,2017.csv,2017,20.9%,79.1%
3475,Read My Lips,5393526,1471911,3921615,2001.csv,2001,27.3%,72.7%
3476,Exit Through the Gift Shop,5386242,3291250,2094992,2010.csv,2010,61.1%,38.9%
3477,Truth,5383097,2541854,2841243,2015.csv,2015,47.2%,52.8%
3478,After the Storm,5382886,272132,5110754,2016.csv,2016,5.1%,94.9%
3479,Won't Back Down,5378228,5310554,67674,2012.csv,2012,98.7%,1.3%
3480,Equilibrium,5359645,1203794,4155851,2002.csv,2002,22.5%,77.5%
3481,Intruders,5348049,69136,5278913,2011.csv,2011,1.3%,98.7%
3482,The Real Cancun,5345083,3825421,1519662,2003.csv,2003,71.6%,28.4%
3483,Much Ado About Nothing,5341221,4328849,1012372,2013.csv,2013,81%,19%
3484,Trollhunter,5341098,253444,5087654,2010.csv,2010,4.7%,95.3%
3485,Sky on fire,5335450,78366,5257084,2016.csv,2016,1.5%,98.5%
3486,He Loves Me... He Loves Me Not,5324097,1011102,4312995,2002.csv,2002,19%,81%
3487,Charlotte Gray,5323109,741394,4581715,2001.csv,2001,13.9%,86.1%
3488,The Meddler 2016 Re-release,5294643,4267218,1027425,2016.csv,2016,80.6%,19.4%
3489,Don't Let Go,5288011,5215062,72949,2019.csv,2019,98.6%,1.4%
3490,The In Crowd,5280035,5280035,0,2000.csv,2000,100%,-
3491,Talaash,5277766,2871956,2405810,2012.csv,2012,54.4%,45.6%
3492,Mustang,5274664,845464,4429200,2015.csv,2015,16%,84%
3493,Glitter,5271666,4274407,997259,2001.csv,2001,81.1%,18.9%
3494,True Story,5261595,4719695,541900,2015.csv,2015,89.7%,10.3%
3495,Nathalie...,5254422,31008,5223414,2004.csv,2004,0.6%,99.4%
3496,The Biggest Little Farm,5247328,4366949,880379,2019.csv,2019,83.2%,16.8%
3497,Kick,5233794,2472695,2761099,2014.csv,2014,47.2%,52.8%
3498,The Dancer Upstairs,5227348,2377348,2850000,2002.csv,2002,45.5%,54.5%
3499,Tucker and Dale vs Evil,5224938,223838,5001100,2010.csv,2010,4.3%,95.7%
3500,Kill the Messenger,5218973,2450846,2768127,2014.csv,2014,47%,53%
3501,The New Girlfriend,5215796,146754,5069042,2014.csv,2014,2.8%,97.2%
3502,Mountains May Depart,5210160,82913,5127247,2015.csv,2015,1.6%,98.4%
3503,Zindagi Na Milegi Dobara,5192743,3108485,2084258,2011.csv,2011,59.9%,40.1%
3504,Atanarjuat: The Fast Runner,5188289,3789952,1398337,2002.csv,2002,73%,27%
3505,Oldboy,5186767,2193658,2993109,2013.csv,2013,42.3%,57.7%
3506,Intermission,5175215,896993,4278222,2003.csv,2003,17.3%,82.7%
3507,My Wife Is an Actress,5169438,1121233,4048205,2001.csv,2001,21.7%,78.3%
3508,The House of Mirth,5164404,3043284,2121120,2000.csv,2000,58.9%,41.1%
3509,MI-5,5161464,0,5161464,2015.csv,2015,-,100%
3510,October Baby 2012 Re-release,5157886,5157886,0,2012.csv,2012,100%,-
3511,Never Look Away,5156805,1304042,3852763,2018.csv,2018,25.3%,74.7%
3512,Grind,5141166,5123696,17470,2003.csv,2003,99.7%,0.3%
3513,Rabbit Hole,5140925,2229058,2911867,2010.csv,2010,43.4%,56.6%
3514,The Legend of Chupacabras,5138140,0,5138140,2016.csv,2016,-,100%
3515,In the Fade,5104991,321011,4783980,2017.csv,2017,6.3%,93.7%
3516,"Buen Día, Ramón",5104868,154356,4950512,2014.csv,2014,3%,97%
3517,Action Point,5103663,5059608,44055,2018.csv,2018,99.1%,0.9%
3518,Serena,5092129,176391,4915738,2014.csv,2014,3.5%,96.5%
3519,Dark Places,5090852,208588,4882264,2014.csv,2014,4.1%,95.9%
3520,Locke,5090608,1375769,3714839,2014.csv,2014,27%,73%
3521,The Liberator,5082098,113067,4969031,2014.csv,2014,2.2%,97.8%
3522,The Sense of an Ending,5081495,1274420,3807075,2017.csv,2017,25.1%,74.9%
3523,Dogman,5080147,148225,4931922,2018.csv,2018,2.9%,97.1%
3524,Anthropoid,5079219,2964845,2114374,2016.csv,2016,58.4%,41.6%
3525,L'auberge espagnole 2003 Re-release,5079086,2830361,2248725,2003.csv,2003,55.7%,44.3%
3526,Konosuba!: God's Blessing on This Wonderful World! - Legend of Crimson,5078942,1134786,3944156,2019.csv,2019,22.3%,77.7%
3527,Doctor Who: The Day of the Doctor,5074950,0,5074950,2013.csv,2013,-,100%
3528,Stand Up Guys,5072654,3310031,1762623,2013.csv,2013,65.3%,34.7%
3529,Mr. X,5061387,44995,5016392,2015.csv,2015,0.9%,99.1%
3530,Monsters,5060438,237301,4823137,2010.csv,2010,4.7%,95.3%
3531,The Proposition,5048693,1903434,3145259,2005.csv,2005,37.7%,62.3%
3532,Table 19,5042014,3614896,1427118,2017.csv,2017,71.7%,28.3%
3533,The Fog of War: Eleven Lessons from the Life of Robert S. McNamara,5038841,4198566,840275,2003.csv,2003,83.3%,16.7%
3534,Kedi,5037923,2835047,2202876,2017.csv,2017,56.3%,43.7%
3535,Breathe,5026154,490131,4536023,2017.csv,2017,9.8%,90.2%
3536,Oranges and Sunshine,5017653,143480,4874173,2011.csv,2011,2.9%,97.1%
3537,Double Lover,5012423,167581,4844842,2017.csv,2017,3.3%,96.7%
3538,Worlds Apart,5011560,60298,4951262,2015.csv,2015,1.2%,98.8%
3539,Bubble Boy,5007898,5007898,0,2001.csv,2001,100%,-
3540,Blindspotting,5006989,4333394,673595,2018.csv,2018,86.5%,13.5%
3541,Alien 2003 Director's Cut,4999112,1986910,3012202,2003.csv,2003,39.7%,60.3%
3542,Hands of Stone,4978353,4712792,265561,2016.csv,2016,94.7%,5.3%
3543,Take This Waltz,4965950,1239692,3726258,2012.csv,2012,25%,75%
3544,Swiss Army Man,4935501,4210454,725047,2016.csv,2016,85.3%,14.7%
3545,Nymphomaniac: Vol. II,4934725,327167,4607558,2014.csv,2014,6.6%,93.4%
3546,Sgt. Stubby: An American Hero,4932694,4015935,916759,2018.csv,2018,81.4%,18.6%
3547,The Anniversary Party,4931888,4047329,884559,2001.csv,2001,82.1%,17.9%
3548,From Justin to Kelly,4928883,4928883,0,2003.csv,2003,100%,-
3549,Desierto,4924990,2002036,2922954,2016.csv,2016,40.7%,59.3%
3550,[REC] 4: Apocalypse,4915757,837,4914920,2014.csv,2014,<0.1%,100%
3551,Samson,4873825,4719928,153897,2018.csv,2018,96.8%,3.2%
3552,The Young Karl Marx,4870373,125659,4744714,2017.csv,2017,2.6%,97.4%
3553,No Man's Land,4858869,1012153,3846716,2001.csv,2001,20.8%,79.2%
3554,Into Great Silence,4857107,790452,4066655,2005.csv,2005,16.3%,83.7%
3555,Silmido,4855181,298347,4556834,2004.csv,2004,6.1%,93.9%
3556,Enron: The Smartest Guys in the Room,4854164,4071700,782464,2005.csv,2005,83.9%,16.1%
3557,Back To The Future Day,4850000,1650000,3200000,2015.csv,2015,34%,66%
3558,Water,4842898,2250329,2592569,2005.csv,2005,46.5%,53.5%
3559,90 Minutes in Heaven,4842699,4842699,0,2015.csv,2015,100%,-
3560,Goliyon Ki Rasleela Ram-Leela,4840059,2738863,2101196,2013.csv,2013,56.6%,43.4%
3561,Jimmy's Hall,4825184,560592,4264592,2014.csv,2014,11.6%,88.4%
3562,Predestination,4824499,68372,4756127,2014.csv,2014,1.4%,98.6%
3563,Capital,4822849,101700,4721149,2012.csv,2012,2.1%,97.9%
3564,Mazinger Z: INFINITY,4812371,220682,4591689,2017.csv,2017,4.6%,95.4%
3565,Trash,4809022,17484,4791538,2014.csv,2014,0.4%,99.6%
3566,Robot & Frank,4806423,3325038,1481385,2012.csv,2012,69.2%,30.8%
3567,Burke and Hare,4791599,4833,4786766,2010.csv,2010,0.1%,99.9%
3568,Ultimate X: The Movie,4786084,4197492,588592,2002.csv,2002,87.7%,12.3%
3569,A Royal Night Out,4779170,228136,4551034,2015.csv,2015,4.8%,95.2%
3570,Martha Marcy May Marlene,4778439,2990625,1787814,2011.csv,2011,62.6%,37.4%
3571,Whipped,4775009,4159986,615023,2000.csv,2000,87.1%,12.9%
3572,Men & Chicken,4765472,30207,4735265,2015.csv,2015,0.6%,99.4%
3573,Force,4763946,0,4763946,2011.csv,2011,-,100%
3574,Slack Bay,4734494,112621,4621873,2016.csv,2016,2.4%,97.6%
3575,The Magdalene Sisters 2003 Re-release,4734466,4583889,150577,2003.csv,2003,96.8%,3.2%
3576,The Double,4729855,137921,4591934,2011.csv,2011,2.9%,97.1%
3577,Clouds of Sils Maria,4728401,1851517,2876884,2014.csv,2014,39.2%,60.8%
3578,The Other Side of Heaven,4720371,4720371,0,2001.csv,2001,100%,-
3579,Sweet Bean,4720010,124800,4595210,2015.csv,2015,2.6%,97.4%
3580,A Housekeeper,4719781,467288,4252493,2002.csv,2002,9.9%,90.1%
3581,Girl in Progress,4709246,2609412,2099834,2012.csv,2012,55.4%,44.6%
3582,Held Up,4705631,4705631,0,2000.csv,2000,100%,-
3583,"Jeff, Who Lives at Home",4704757,4269426,435331,2012.csv,2012,90.7%,9.3%
3584,Unlocked,4699125,0,4699125,2017.csv,2017,-,100%
3585,Menteur,4697364,4697364,0,2019.csv,2019,100%,-
3586,Jay and Silent Bob Reboot,4691248,4589490,101758,2019.csv,2019,97.8%,2.2%
3587,Bodyguard,4690492,1834384,2856108,2011.csv,2011,39.1%,60.9%
3588,Keith Lemon: The Film,4682943,0,4682943,2012.csv,2012,-,100%
3589,The Runaways,4681651,3573673,1107978,2010.csv,2010,76.3%,23.7%
3590,The Woodsman,4678405,1576231,3102174,2004.csv,2004,33.7%,66.3%
3591,Lovely & Amazing,4677852,4222923,454929,2002.csv,2002,90.3%,9.7%
3592,Warriors of the Rainbow: Seediq Bale I,4670432,136166,4534266,2011.csv,2011,2.9%,97.1%
3593,Where to Invade Next,4664756,3827261,837495,2016.csv,2016,82%,18%
3594,Don't Come Knocking,4663501,440793,4222708,2005.csv,2005,9.5%,90.5%
3595,A Simple Life,4663094,191826,4471268,2012.csv,2012,4.1%,95.9%
3596,Tubelight,4650456,930058,3720398,2017.csv,2017,20%,80%
3597,Blood and Bones,4649617,0,4649617,2004.csv,2004,-,100%
3598,Rize,4646889,3336391,1310498,2005.csv,2005,71.8%,28.2%
3599,Gemma Bovery,4644525,191533,4452992,2014.csv,2014,4.1%,95.9%
3600,Everybody Wants Some!!,4644472,3400278,1244194,2016.csv,2016,73.2%,26.8%
3601,Dear White People,4633961,4404154,229807,2014.csv,2014,95%,5%
3602,Killer Joe,4633668,1987762,2645906,2012.csv,2012,42.9%,57.1%
3603,Hamlet 2018 Re-release,4630718,235229,4395489,2018.csv,2018,5.1%,94.9%
3604,Atlas Shrugged: Part I,4627375,4627375,0,2011.csv,2011,100%,-
3605,Heneral Luna,4625639,206040,4419599,2015.csv,2015,4.5%,95.5%
3606,Housefull 4,4624936,2109160,2515776,2019.csv,2019,45.6%,54.4%
3607,Bad Samaritan,4623836,3435047,1188789,2018.csv,2018,74.3%,25.7%
3608,A Hidden Life,4608154,1730597,2877557,2019.csv,2019,37.6%,62.4%
3609,The Last Black Man in San Francisco,4607017,4515719,91298,2019.csv,2019,98%,2%
3610,Whitney,4605123,3026351,1578772,2018.csv,2018,65.7%,34.3%
3611,The Guilty,4598051,207140,4390911,2018.csv,2018,4.5%,95.5%
3612,The Book of Henry,4596705,4504974,91731,2017.csv,2017,98%,2%
3613,Tortilla Soup,4574762,4467615,107147,2001.csv,2001,97.7%,2.3%
3614,Labyrinth of Lies,4574756,794452,3780304,2014.csv,2014,17.4%,82.6%
3615,Find a Boyfriend for My Wife... PLEASE!,4570757,1741889,2828868,2016.csv,2016,38.1%,61.9%
3616,The Beach Bum,4554416,3502600,1051816,2019.csv,2019,76.9%,23.1%
3617,The Iceman,4552970,1969193,2583777,2013.csv,2013,43.3%,56.7%
3618,The Keys to the House,4537451,0,4537451,2004.csv,2004,-,100%
3619,Colossal,4531320,3029287,1502033,2017.csv,2017,66.9%,33.1%
3620,Cezanne et Moi,4529583,257597,4271986,2016.csv,2016,5.7%,94.3%
3621,Maps to the Stars,4510934,350741,4160193,2014.csv,2014,7.8%,92.2%
3622,"Juliet, Naked",4508260,3444895,1063365,2018.csv,2018,76.4%,23.6%
3623,Simon & the Oaks,4505573,150664,4354909,2011.csv,2011,3.3%,96.7%
3624,Barfi!,4490134,2804874,1685260,2012.csv,2012,62.5%,37.5%
3625,Bullhead,4483147,151840,4331307,2011.csv,2011,3.4%,96.6%
3626,The Wall,4476705,1803064,2673641,2017.csv,2017,40.3%,59.7%
3627,Woman at War,4471158,847495,3623663,2018.csv,2018,19%,81%
3628,Batman: The Killing Joke,4462034,3775000,687034,2016.csv,2016,84.6%,15.4%
3629,Flypaper,4453634,5043,4448591,2011.csv,2011,0.1%,99.9%
3630,Buck,4448728,4038912,409816,2011.csv,2011,90.8%,9.2%
3631,In Harm's Way,4447734,0,4447734,2017.csv,2017,-,100%
3632,Mental,4446852,17669,4429183,2012.csv,2012,0.4%,99.6%
3633,Walk on Water,4444265,2713932,1730333,2004.csv,2004,61.1%,38.9%
3634,Leviathan,4439481,1092800,3346681,2014.csv,2014,24.6%,75.4%
3635,The Return,4429093,504256,3924837,2003.csv,2003,11.4%,88.6%
3636,Samsara,4426444,2672413,1754031,2012.csv,2012,60.4%,39.6%
3637,The Assassination of Richard Nixon,4426087,708776,3717311,2004.csv,2004,16%,84%
3638,Safety Not Guaranteed,4424699,4010957,413742,2012.csv,2012,90.6%,9.4%
3639,Don't Think Twice,4417667,4417667,0,2016.csv,2016,100%,-
3640,Laurel Canyon,4412203,3663356,748847,2003.csv,2003,83%,17%
3641,The Commune,4410339,38737,4371602,2016.csv,2016,0.9%,99.1%
3642,Thérèse,4408087,101944,4306143,2012.csv,2012,2.3%,97.7%
3643,Jab Harry Met Sejal,4407775,1664648,2743127,2017.csv,2017,37.8%,62.2%
3644,The Tao of Steve,4406030,4342203,63827,2000.csv,2000,98.6%,1.4%
3645,My Spy,4405156,0,4405156,2020.csv,2020,-,100%
3646,On the Line,4403019,4365455,37564,2001.csv,2001,99.1%,0.9%
3647,The Eagle Huntress,4400140,3169351,1230789,2016.csv,2016,72%,28%
3648,360,4396975,100343,4296632,2012.csv,2012,2.3%,97.7%
3649,Kabali,4388789,3903095,485694,2016.csv,2016,88.9%,11.1%
3650,White Elephant,4387907,8884,4379023,2012.csv,2012,0.2%,99.8%
3651,Clown,4381603,55007,4326596,2014.csv,2014,1.3%,98.7%
3652,Brian Banks,4376819,4376819,0,2019.csv,2019,100%,-
3653,Seven Days in Utopia,4373074,4373074,0,2011.csv,2011,100%,-
3654,There Be Dragons,4372642,1069334,3303308,2011.csv,2011,24.5%,75.5%
3655,Mark Felt: The Man Who Brought Down the White House,4372130,768946,3603184,2017.csv,2017,17.6%,82.4%
3656,Demolition,4366460,1978592,2387868,2016.csv,2016,45.3%,54.7%
3657,King of Devil's Island,4360391,7615,4352776,2010.csv,2010,0.2%,99.8%
3658,Blinky Bill the Movie,4344536,0,4344536,2015.csv,2015,-,100%
3659,Standing Tall,4323120,26144,4296976,2015.csv,2015,0.6%,99.4%
3660,Please Give,4313829,4033574,280255,2010.csv,2010,93.5%,6.5%
3661,Uri: The Surgical Strike 2019 Re-release,4302454,4186168,116286,2019.csv,2019,97.3%,2.7%
3662,Swift,4299329,0,4299329,2019.csv,2019,-,100%
3663,Soul Survivors,4299141,3111545,1187596,2001.csv,2001,72.4%,27.6%
3664,The Grand Seduction,4292517,3430018,862499,2014.csv,2014,79.9%,20.1%
3665,High-Rise,4286576,346472,3940104,2016.csv,2016,8.1%,91.9%
3666,Caterina in the Big City,4285937,296464,3989473,2003.csv,2003,6.9%,93.1%
3667,The Other Side of Hope,4282973,183943,4099030,2017.csv,2017,4.3%,95.7%
3668,Mohabbatein,4279351,1070000,3209351,2000.csv,2000,25%,75%
3669,Storm Boy,4266224,71760,4194464,2018.csv,2018,1.7%,98.3%
3670,Linda Ronstadt: The Sound of My Voice,4252657,4252657,0,2019.csv,2019,100%,-
3671,Men with Brooms,4245870,4245870,0,2002.csv,2002,100%,-
3672,Santa vs. the Snowman 3D 2004 Re-release,4243755,1926034,2317721,2004.csv,2004,45.4%,54.6%
3673,Heaven,4243537,784399,3459138,2002.csv,2002,18.5%,81.5%
3674,"Don't Worry, He Won't Get Far on Foot",4241656,1441705,2799951,2018.csv,2018,34%,66%
3675,"Good Morning, Night",4234655,10093,4224562,2003.csv,2003,0.2%,99.8%
3676,Branded,4227984,353513,3874471,2012.csv,2012,8.4%,91.6%
3677,Left Behind: The Movie,4224065,4224065,0,2001.csv,2001,100%,-
3678,Dabangg 2,4216988,2519190,1697798,2012.csv,2012,59.7%,40.3%
3679,The Rabbi's Cat,4208573,23392,4185181,2011.csv,2011,0.6%,99.4%
3680,Diplomacy,4207242,230880,3976362,2014.csv,2014,5.5%,94.5%
3681,Let the Sunshine In,4192590,892421,3300169,2017.csv,2017,21.3%,78.7%
3682,Sheep & Wolves,4190750,0,4190750,2016.csv,2016,-,100%
3683,Song of the Sea,4190670,857522,3333148,2014.csv,2014,20.5%,79.5%
3684,Evelyn,4186916,1487645,2699271,2002.csv,2002,35.5%,64.5%
3685,Tanu Weds Manu Returns,4180081,3043479,1136602,2015.csv,2015,72.8%,27.2%
3686,Changing Times,4178714,545255,3633459,2004.csv,2004,13%,87%
3687,East Is East,4177818,4177818,0,2000.csv,2000,100%,-
3688,Nitro Circus: The Movie,4174269,3377618,796651,2012.csv,2012,80.9%,19.1%
3689,Welcome to Collinwood,4172703,336620,3836083,2002.csv,2002,8.1%,91.9%
3690,Krrish 3,4170204,2191534,1978670,2013.csv,2013,52.6%,47.4%
3691,The Guardians,4167608,177331,3990277,2017.csv,2017,4.3%,95.7%
3692,Dil Dhadakne Do,4161630,3066100,1095530,2015.csv,2015,73.7%,26.3%
3693,A Quiet Passion,4159246,1865396,2293850,2016.csv,2016,44.8%,55.2%
3694,King's Ransom,4143652,4008527,135125,2005.csv,2005,96.7%,3.3%
3695,Edison,4143414,0,4143414,2005.csv,2005,-,100%
3696,Savage,4140502,74491,4066011,2019.csv,2019,1.8%,98.2%
3697,The Last Princess,4135255,29259,4105996,2016.csv,2016,0.7%,99.3%
3698,Ghost Stories,4131358,148747,3982611,2018.csv,2018,3.6%,96.4%
3699,Apartment 143,4126744,383,4126361,2012.csv,2012,<0.1%,100%
3700,Arctic 2019 Re-release,4124015,2410795,1713220,2019.csv,2019,58.5%,41.5%
3701,Carancho,4120012,85526,4034486,2010.csv,2010,2.1%,97.9%
3702,The Fall of the American Empire,4110928,2178460,1932468,2018.csv,2018,53%,47%
3703,Naam Hai Akira,4108063,219401,3888662,2016.csv,2016,5.3%,94.7%
3704,The Hero,4101699,4077333,24366,2017.csv,2017,99.4%,0.6%
3705,Japanese Story,4095954,647054,3448900,2003.csv,2003,15.8%,84.2%
3706,Force Majeure,4094339,1359497,2734842,2014.csv,2014,33.2%,66.8%
3707,The White Countess,4092682,1669971,2422711,2005.csv,2005,40.8%,59.2%
3708,American Animals,4080073,2856954,1223119,2018.csv,2018,70%,30%
3709,Katti Batti,4079135,364932,3714203,2015.csv,2015,8.9%,91.1%
3710,Capturing the Friedmans,4076990,3119113,957877,2003.csv,2003,76.5%,23.5%
3711,Bossa Nova,4069261,1823297,2245964,2000.csv,2000,44.8%,55.2%
3712,The Visual Bible: The Gospel of John,4069090,4069090,0,2003.csv,2003,100%,-
3713,Grizzly Man,4061305,3178403,882902,2005.csv,2005,78.3%,21.7%
3714,From Prada to Nada,4058694,3033623,1025071,2011.csv,2011,74.7%,25.3%
3715,2 Days in New York,4058113,633210,3424903,2012.csv,2012,15.6%,84.4%
3716,The Killer Inside Me,4050140,217277,3832863,2010.csv,2010,5.4%,94.6%
3717,Film Stars Don't Die in Liverpool,4047917,1026124,3021793,2017.csv,2017,25.3%,74.7%
3718,Love in the Buff,4045381,256451,3788930,2012.csv,2012,6.3%,93.7%
3719,Step Into Liquid,4041588,3681803,359785,2003.csv,2003,91.1%,8.9%
3720,Metropolis,4035192,722932,3312260,2002.csv,2002,17.9%,82.1%
3721,Housefull 2,4035090,1791780,2243310,2012.csv,2012,44.4%,55.6%
3722,Schultze Gets the Blues,4034232,595071,3439161,2004.csv,2004,14.8%,85.2%
3723,Junglee,4033587,295784,3737803,2019.csv,2019,7.3%,92.7%
3724,Rare Exports,4028971,236347,3792624,2010.csv,2010,5.9%,94.1%
3725,Vulgaria,4028543,59059,3969484,2012.csv,2012,1.5%,98.5%
3726,Jeepers Creepers III,4017852,2335162,1682690,2017.csv,2017,58.1%,41.9%
3727,A Perfect Day,4009440,14044,3995396,2015.csv,2015,0.4%,99.6%
3728,Penguin Highway,4006647,104567,3902080,2018.csv,2018,2.6%,97.4%
3729,Faces Places,3998450,953717,3044733,2017.csv,2017,23.9%,76.1%
3730,Sleight,3989705,3986245,3460,2017.csv,2017,99.9%,<0.1%
3731,The Invisible Woman,3986888,1234254,2752634,2013.csv,2013,31%,69%
3732,Le petit lieutenant,3984265,216724,3767541,2005.csv,2005,5.4%,94.6%
3733,The Nile Hilton Incident,3979536,81089,3898447,2017.csv,2017,2%,98%
3734,Ip Man: The Final Fight,3967001,37884,3929117,2013.csv,2013,1%,99%
3735,Lucifer,3956978,0,3956978,2019.csv,2019,-,100%
3736,The Devil's Violinist,3952097,11294,3940803,2013.csv,2013,0.3%,99.7%
3737,Bully 2012 Re-release,3950244,3863446,86798,2012.csv,2012,97.8%,2.2%
3738,2:22,3945729,422,3945307,2017.csv,2017,<0.1%,100%
3739,Breakfast on Pluto,3942254,828699,3113555,2005.csv,2005,21%,79%
3740,Terminator 2: Judgment Day 2017 Re-release,3931111,1037809,2893302,2017.csv,2017,26.4%,73.6%
3741,Ride Your Wave,3927015,332432,3594583,2019.csv,2019,8.5%,91.5%
3742,Welcome to the Punch,3926386,9747,3916639,2013.csv,2013,0.2%,99.8%
3743,Loveless,3925992,566356,3359636,2017.csv,2017,14.4%,85.6%
3744,Indignation,3924527,3401155,523372,2016.csv,2016,86.7%,13.3%
3745,Mrs. Palfrey at the Claremont,3919275,1720953,2198322,2005.csv,2005,43.9%,56.1%
3746,A Private War,3915207,1633208,2281999,2018.csv,2018,41.7%,58.3%
3747,The To Do List,3909596,3491669,417927,2013.csv,2013,89.3%,10.7%
3748,The Starving Games,3906308,0,3906308,2013.csv,2013,-,100%
3749,Taxi,3906227,321642,3584585,2015.csv,2015,8.2%,91.8%
3750,Camping sauvage,3900099,3894585,5514,2004.csv,2004,99.9%,0.1%
3751,The Wall,3889260,38674,3850586,2012.csv,2012,1%,99%
3752,Osama,3888902,1270904,2617998,2003.csv,2003,32.7%,67.3%
3753,Rules Don't Apply,3885342,3652206,233136,2016.csv,2016,94%,6%
3754,Neruda,3884746,939101,2945645,2016.csv,2016,24.2%,75.8%
3755,The Perfect Game,3878993,1037071,2841922,2010.csv,2010,26.7%,73.3%
3756,"The Night Is Short, Walk on Girl",3878208,406490,3471718,2017.csv,2017,10.5%,89.5%
3757,Django,3876874,56556,3820318,2017.csv,2017,1.5%,98.5%
3758,Horns,3875442,173948,3701494,2014.csv,2014,4.5%,95.5%
3759,Submarine,3875173,467602,3407571,2011.csv,2011,12.1%,87.9%
3760,First Reformed,3862498,3448256,414242,2018.csv,2018,89.3%,10.7%
3761,Lan Yu,3847964,116325,3731639,2001.csv,2001,3%,97%
3762,Frozen,3843774,246176,3597598,2010.csv,2010,6.4%,93.6%
3763,Marley,3842919,1413480,2429439,2012.csv,2012,36.8%,63.2%
3764,To Save a Life,3824868,3777210,47658,2010.csv,2010,98.8%,1.2%
3765,2001: A Space Odyssey 2017 Re-release,3823450,3236321,587129,2017.csv,2017,84.6%,15.4%
3766,Elles,3822241,157508,3664733,2012.csv,2012,4.1%,95.9%
3767,The Other Son,3820405,1285918,2534487,2012.csv,2012,33.7%,66.3%
3768,The Homesman,3819421,2429989,1389432,2014.csv,2014,63.6%,36.4%
3769,Benji: Off the Leash!,3817362,3817362,0,2004.csv,2004,100%,-
3770,Brad's Status,3816527,2133158,1683369,2017.csv,2017,55.9%,44.1%
3771,Green Street Hooligans,3814717,346830,3467887,2005.csv,2005,9.1%,90.9%
3772,Sweet 20,3810429,71775,3738654,2015.csv,2015,1.9%,98.1%
3773,Better Luck Tomorrow,3809226,3802390,6836,2003.csv,2003,99.8%,0.2%
3774,Custody,3790303,83882,3706421,2018.csv,2018,2.2%,97.8%
3775,The Paperboy,3783865,693286,3090579,2012.csv,2012,18.3%,81.7%
3776,Donnie Darko 2004 Director's Cut,3782231,753147,3029084,2004.csv,2004,19.9%,80.1%
3777,Citizenfour,3780692,2800870,979822,2014.csv,2014,74.1%,25.9%
3778,Green Room,3769214,3220371,548843,2016.csv,2016,85.4%,14.6%
3779,The Secret Lives of Dentists,3764286,3707346,56940,2003.csv,2003,98.5%,1.5%
3780,Before the Fall,3764219,144254,3619965,2005.csv,2005,3.8%,96.2%
3781,Kings & Queen,3761583,290973,3470610,2004.csv,2004,7.7%,92.3%
3782,Black Sea,3758103,1171559,2586544,2014.csv,2014,31.2%,68.8%
3783,The Trip,3741198,2030962,1710236,2011.csv,2011,54.3%,45.7%
3784,Take Shelter,3741098,1730296,2010802,2011.csv,2011,46.3%,53.7%
3785,Up at the Villa,3740113,2933161,806952,2000.csv,2000,78.4%,21.6%
3786,Like Crazy,3731489,3395391,336098,2011.csv,2011,91%,9%
3787,The Big Kahuna,3728888,3165544,563344,2000.csv,2000,84.9%,15.1%
3788,Ragnarok,3721345,1369,3719976,2013.csv,2013,<0.1%,100%
3789,Free Fire,3719383,1799312,1920071,2017.csv,2017,48.4%,51.6%
3790,Summertime,3719031,35322,3683709,2015.csv,2015,0.9%,99.1%
3791,Night of 7 Years,3716820,24281,3692539,2018.csv,2018,0.7%,99.3%
3792,Thirteen Conversations About One Thing,3706652,3288164,418488,2002.csv,2002,88.7%,11.3%
3793,The Last King,3705618,8905,3696713,2016.csv,2016,0.2%,99.8%
3794,A Fantastic Woman,3702353,2020988,1681365,2017.csv,2017,54.6%,45.4%
3795,Spare Parts,3701281,3618912,82369,2015.csv,2015,97.8%,2.2%
3796,Crush,3695710,1084935,2610775,2002.csv,2002,29.4%,70.6%
3797,Western Stars,3681681,1581681,2100000,2019.csv,2019,43%,57%
3798,1911,3680151,135739,3544412,2011.csv,2011,3.7%,96.3%
3799,Gosnell: The Trial of America's Biggest Serial Killer,3679893,3679893,0,2018.csv,2018,100%,-
3800,5 Flights Up,3679847,1020921,2658926,2015.csv,2015,27.7%,72.3%
3801,Love Crime,3663918,539792,3124126,2010.csv,2010,14.7%,85.3%
3802,Ju-on: The Grudge,3657876,325680,3332196,2003.csv,2003,8.9%,91.1%
3803,"Lucía, Lucía",3653588,269586,3384002,2003.csv,2003,7.4%,92.6%
3804,Nicholas Nickleby,3651462,1587173,2064289,2002.csv,2002,43.5%,56.5%
3805,Number One Fan,3650598,15549,3635049,2014.csv,2014,0.4%,99.6%
3806,Non-Fiction,3648552,704919,2943633,2018.csv,2018,19.3%,80.7%
3807,The Cat's Meow,3646994,3209481,437513,2002.csv,2002,88%,12%
3808,A la mala,3646627,3629842,16785,2015.csv,2015,99.5%,0.5%
3809,Hedwig and the Angry Inch,3644200,3067312,576888,2001.csv,2001,84.2%,15.8%
3810,Celeste & Jesse Forever,3640975,3094813,546162,2012.csv,2012,85%,15%
3811,Bhoot,3640472,106774,3533698,2003.csv,2003,2.9%,97.1%
3812,The German Doctor,3635718,418392,3217326,2013.csv,2013,11.5%,88.5%
3813,Sweet Sixteen,3633509,316319,3317190,2002.csv,2002,8.7%,91.3%
3814,Crooked House,3625952,0,3625952,2017.csv,2017,-,100%
3815,Colonia,3621046,15709,3605337,2016.csv,2016,0.4%,99.6%
3816,The Last Circus,3604598,40548,3564050,2010.csv,2010,1.1%,98.9%
3817,Everything Is Illuminated,3601974,1712337,1889637,2005.csv,2005,47.5%,52.5%
3818,The Insult,3601603,1001305,2600298,2017.csv,2017,27.8%,72.2%
3819,Phoenix Forgotten,3600146,3600146,0,2017.csv,2017,100%,-
3820,Heart Blackened,3593480,37047,3556433,2017.csv,2017,1%,99%
3821,Badla,3590894,1861000,1729894,2019.csv,2019,51.8%,48.2%
3822,Indivisible,3589633,3511417,78216,2018.csv,2018,97.8%,2.2%
3823,Agneepath,3582446,1986748,1595698,2012.csv,2012,55.5%,44.5%
3824,Ghostbusters 30th Anniversary Release,3580343,3580343,0,2014.csv,2014,100%,-
3825,Lemming,3580017,81698,3498319,2005.csv,2005,2.3%,97.7%
3826,Paradise Now,3579902,1457843,2122059,2005.csv,2005,40.7%,59.3%
3827,The Apparition,3562793,28293,3534500,2018.csv,2018,0.8%,99.2%
3828,2 States,3558887,2238174,1320713,2014.csv,2014,62.9%,37.1%
3829,Les Boys III,3557100,3557100,0,2001.csv,2001,100%,-
3830,Price of Glory,3548556,3440228,108328,2000.csv,2000,96.9%,3.1%
3831,The Oscar Nominated Short Films 2019: Documentary,3538550,3531094,7456,2019.csv,2019,99.8%,0.2%
3832,Catfish,3533711,3237343,296368,2010.csv,2010,91.6%,8.4%
3833,Ek Ladki Ko Dekha Toh Aisa Laga,3531837,1182636,2349201,2019.csv,2019,33.5%,66.5%
3834,Born Into Brothels: Calcutta's Red Light Kids,3529201,3515061,14140,2004.csv,2004,99.6%,0.4%
3835,Sidewalks of New York,3520373,2402652,1117721,2001.csv,2001,68.2%,31.8%
3836,The Riot Club,3517925,7734,3510191,2014.csv,2014,0.2%,99.8%
3837,The Oscar Nominated Short Films 2018: Live Action,3511123,3508777,2346,2018.csv,2018,99.9%,<0.1%
3838,Head in the Clouds,3510605,398278,3112327,2004.csv,2004,11.3%,88.7%
3839,Ladrones,3504414,3063505,440909,2015.csv,2015,87.4%,12.6%
3840,Thanks for Sharing,3499442,1065881,2433561,2013.csv,2013,30.5%,69.5%
3841,Faustina: Love and Mercy,3498887,2243180,1255707,2019.csv,2019,64.1%,35.9%
3842,Maiden,3495241,3168978,326263,2019.csv,2019,90.7%,9.3%
3843,Wild Target,3494154,108589,3385565,2010.csv,2010,3.1%,96.9%
3844,Where the Truth Lies,3487678,872142,2615536,2005.csv,2005,25%,75%
3845,Veronica Mars,3485383,3322127,163256,2014.csv,2014,95.3%,4.7%
3846,3,3484446,59954,3424492,2010.csv,2010,1.7%,98.3%
3847,Jack and the Cuckoo-Clock Heart,3484370,0,3484370,2014.csv,2014,-,100%
3848,Miles Ahead,3473958,2610896,863062,2016.csv,2016,75.2%,24.8%
3849,The Metropolitan Opera HD Live: Puccini: Tosca,3473616,2023749,1449867,2018.csv,2018,58.3%,41.7%
3850,The Method,3470651,7017,3463634,2005.csv,2005,0.2%,99.8%
3851,Hors la loi,3470487,96933,3373554,2010.csv,2010,2.8%,97.2%
3852,Enemy,3468224,1008726,2459498,2014.csv,2014,29.1%,70.9%
3853,The Long Weekend,3467374,1286,3466088,2005.csv,2005,<0.1%,100%
3854,Til Death Do Us Part,3455267,3455267,0,2017.csv,2017,100%,-
3855,Obsession,3454709,528799,2925910,2016.csv,2016,15.3%,84.7%
3856,Separate Lies,3452023,924260,2527763,2005.csv,2005,26.8%,73.2%
3857,Racetime,3439053,1875283,1563770,2018.csv,2018,54.5%,45.5%
3858,Words and Pictures,3438874,2171257,1267617,2014.csv,2014,63.1%,36.9%
3859,Full Frontal,3438804,2512846,925958,2002.csv,2002,73.1%,26.9%
3860,A Gentleman,3438746,410055,3028691,2017.csv,2017,11.9%,88.1%
3861,The Rider,3434963,2419031,1015932,2018.csv,2018,70.4%,29.6%
3862,2001: A Space Odyssey 2001 Re-release,3434270,239621,3194649,2001.csv,2001,7%,93%
3863,He Named Me Malala,3433606,2668936,764670,2015.csv,2015,77.7%,22.3%
3864,Borg vs. McEnroe,3430165,231346,3198819,2017.csv,2017,6.7%,93.3%
3865,Disconnect,3428048,1436900,1991148,2013.csv,2013,41.9%,58.1%
3866,Special Forces,3424648,10759,3413889,2011.csv,2011,0.3%,99.7%
3867,Bacurau,3423433,58115,3365318,2019.csv,2019,1.7%,98.3%
3868,Next Time I'll Aim for the Heart,3418213,815,3417398,2014.csv,2014,<0.1%,100%
3869,The Cave of the Yellow Dog,3417511,141803,3275708,2005.csv,2005,4.1%,95.9%
3870,Midnight Diner,3412771,18555,3394216,2019.csv,2019,0.5%,99.5%
3871,3-Iron,3403957,241914,3162043,2004.csv,2004,7.1%,92.9%
3872,Friends 25th: The One With The Anniversary,3403406,2884827,518579,2019.csv,2019,84.8%,15.2%
3873,Warrior King 2,3399790,2463,3397327,2013.csv,2013,<0.1%,99.9%
3874,Junebug,3399228,2678691,720537,2005.csv,2005,78.8%,21.2%
3875,The Good Lie,3396345,2722209,674136,2014.csv,2014,80.2%,19.8%
3876,Rock the Kasbah,3394174,3020664,373510,2015.csv,2015,89%,11%
3877,"All's Well, Ends Well 2012",3390232,47919,3342313,2012.csv,2012,1.4%,98.6%
3878,Gauguin: Voyage to Tahiti,3389322,200140,3189182,2017.csv,2017,5.9%,94.1%
3879,Anything for Alice,3387582,1092,3386490,2014.csv,2014,<0.1%,100%
3880,Apartment 1303 3D,3377891,0,3377891,2012.csv,2012,-,100%
3881,The Neon Demon,3377430,1333124,2044306,2016.csv,2016,39.5%,60.5%
3882,Red Satin,3375341,231879,3143462,2002.csv,2002,6.9%,93.1%
3883,The King's Speech PG-13 Version,3375215,3344306,30909,2011.csv,2011,99.1%,0.9%
3884,The Hole in the Ground,3373474,21072,3352402,2019.csv,2019,0.6%,99.4%
3885,Bunty Aur Babli,3370142,942756,2427386,2005.csv,2005,28%,72%
3886,Sunshine State,3369654,3065921,303733,2002.csv,2002,91%,9%
3887,Patrick the Pug,3369468,6290,3363178,2018.csv,2018,0.2%,99.8%
3888,We Don't Live Here Anymore,3361213,2041014,1320199,2004.csv,2004,60.7%,39.3%
3889,Echo in the Canyon,3355324,3355324,0,2019.csv,2019,100%,-
3890,Reality,3350996,72577,3278419,2012.csv,2012,2.2%,97.8%
3891,The Work and the Glory,3347647,3347647,0,2004.csv,2004,100%,-
3892,Supercross,3344431,3102550,241881,2005.csv,2005,92.8%,7.2%
3893,Mistress America,3340737,2500431,840306,2015.csv,2015,74.8%,25.2%
3894,No News from God,3340382,77858,3262524,2002.csv,2002,2.3%,97.7%
3895,Machine Gun Preacher,3338690,538690,2800000,2011.csv,2011,16.1%,83.9%
3896,Atlas Shrugged II: The Strike,3336053,3336053,0,2012.csv,2012,100%,-
3897,On Chesil Beach,3335913,745971,2589942,2018.csv,2018,22.4%,77.6%
3898,The Program,3335613,13074,3322539,2015.csv,2015,0.4%,99.6%
3899,By the Sea,3334927,538460,2796467,2015.csv,2015,16.1%,83.9%
3900,Raiders of the Lost Ark 2012 IMAX Release,3332854,3125613,207241,2012.csv,2012,93.8%,6.2%
3901,Last Ounce of Courage,3329674,3329674,0,2012.csv,2012,100%,-
3902,Vanishing Time: A Boy Who Returned,3328517,57759,3270758,2016.csv,2016,1.7%,98.3%
3903,The Death and Life of John F. Donovan,3326364,152713,3173651,2019.csv,2019,4.6%,95.4%
3904,Obvious Child,3325417,3123963,201454,2014.csv,2014,93.9%,6.1%
3905,Flying Swords of Dragon Gate,3323381,170276,3153105,2011.csv,2011,5.1%,94.9%
3906,Breath,3322479,37108,3285371,2018.csv,2018,1.1%,98.9%
3907,Wildlife,3321367,1050616,2270751,2018.csv,2018,31.6%,68.4%
3908,Pootie Tang,3313583,3313583,0,2001.csv,2001,100%,-
3909,Chhichhore,3307350,2004400,1302950,2019.csv,2019,60.6%,39.4%
3910,The House That Jack Built,3297010,170113,3126897,2018.csv,2018,5.2%,94.8%
3911,Heist,3294317,50136,3244181,2015.csv,2015,1.5%,98.5%
3912,Bluff Master,3289047,722847,2566200,2005.csv,2005,22%,78%
3913,Wonderstruck,3285916,1060377,2225539,2017.csv,2017,32.3%,67.7%
3914,Good Time,3283369,2026499,1256870,2017.csv,2017,61.7%,38.3%
3915,Bharath Ane Nenu,3276257,2663090,613167,2018.csv,2018,81.3%,18.7%
3916,Pieces of April,3272028,2528664,743364,2003.csv,2003,77.3%,22.7%
3917,Honey Boy,3270077,3012615,257462,2019.csv,2019,92.1%,7.9%
3918,Chicken with Plums,3265941,253874,3012067,2011.csv,2011,7.8%,92.2%
3919,Marianne & Leonard: Words of Love,3260620,1012034,2248586,2019.csv,2019,31%,69%
3920,Clifford's Really Big Movie,3255426,2922354,333072,2004.csv,2004,89.8%,10.2%
3921,Little Fish,3248506,8148,3240358,2005.csv,2005,0.3%,99.7%
3922,Queens,3245067,140417,3104650,2005.csv,2005,4.3%,95.7%
3923,Your Sister's Sister,3242802,1636190,1606612,2012.csv,2012,50.5%,49.5%
3924,En Équilibre,3242445,3144,3239301,2015.csv,2015,<0.1%,99.9%
3925,The Front Runner,3242235,2000105,1242130,2018.csv,2018,61.7%,38.3%
3926,Sleeping with Other People,3224947,819431,2405516,2015.csv,2015,25.4%,74.6%
3927,The Final Cut,3222439,551281,2671158,2004.csv,2004,17.1%,82.9%
3928,Love Is in the Air 2013 Re-release,3221554,8425,3213129,2013.csv,2013,0.3%,99.7%
3929,Gun Shy,3221280,1638202,1583078,2000.csv,2000,50.9%,49.1%
3930,The Wild Parrots of Telegraph Hill,3218709,3058527,160182,2005.csv,2005,95%,5%
3931,Embrace of the Serpent,3217176,1329249,1887927,2015.csv,2015,41.3%,58.7%
3932,The Mystery of Happiness,3216374,8528,3207846,2014.csv,2014,0.3%,99.7%
3933,Riding Giants,3216111,2276368,939743,2004.csv,2004,70.8%,29.2%
3934,6 Souls,3205167,0,3205167,2010.csv,2010,-,100%
3935,Saint Laurent,3202241,429477,2772764,2014.csv,2014,13.4%,86.6%
3936,Tadpole,3200241,2891288,308953,2002.csv,2002,90.3%,9.7%
3937,I,3200113,1449232,1750881,2015.csv,2015,45.3%,54.7%
3938,Dear Zindagi,3199581,2376479,823102,2016.csv,2016,74.3%,25.7%
3939,Fill the Void,3197615,1775316,1422299,2012.csv,2012,55.5%,44.5%
3940,Victoria,3191971,0,3191971,2015.csv,2015,-,100%
3941,Empire of Lust,3191168,10654,3180514,2015.csv,2015,0.3%,99.7%
3942,Machuca,3187700,26676,3161024,2004.csv,2004,0.8%,99.2%
3943,Thoroughbreds,3187255,3072605,114650,2018.csv,2018,96.4%,3.6%
3944,Showtime Championship Boxing: Floyd Mayweather vs. Conor McGregor,3184384,2620183,564201,2017.csv,2017,82.3%,17.7%
3945,Strayed,3184020,482757,2701263,2003.csv,2003,15.2%,84.8%
3946,Madame 2017 Re-release,3182153,90979,3091174,2017.csv,2017,2.9%,97.1%
3947,Tea With the Dames,3181152,889343,2291809,2018.csv,2018,28%,72%
3948,Pastorela,3179022,161194,3017828,2011.csv,2011,5.1%,94.9%
3949,Waking Life,3176880,2901447,275433,2001.csv,2001,91.3%,8.7%
3950,Pilgrim's Progress,3173282,1294596,1878686,2019.csv,2019,40.8%,59.2%
3951,Rosewater,3171593,3128941,42652,2014.csv,2014,98.7%,1.3%
3952,Songcatcher,3171273,3059834,111439,2001.csv,2001,96.5%,3.5%
3953,Beautiful,3169930,3157348,12582,2000.csv,2000,99.6%,0.4%
3954,Land of Mine,3169553,435266,2734287,2015.csv,2015,13.7%,86.3%
3955,Race 2,3164441,1579940,1584501,2013.csv,2013,49.9%,50.1%
3956,The Bridesmaid,3162662,111728,3050934,2004.csv,2004,3.5%,96.5%
3957,Ingrid Goes West,3146831,3024308,122523,2017.csv,2017,96.1%,3.9%
3958,Genesis,3139313,16413,3122900,2004.csv,2004,0.5%,99.5%
3959,Munna Bhai M.B.B.S.,3137716,48772,3088944,2003.csv,2003,1.6%,98.4%
3960,The Deep Blue Sea,3115609,1126525,1989084,2011.csv,2011,36.2%,63.8%
3961,In a World...,3114953,2963902,151051,2013.csv,2013,95.2%,4.8%
3962,Come Undone,3101465,10035,3091430,2010.csv,2010,0.3%,99.7%
3963,Close Encounters of the Third Kind 2017 Re-release,3100479,3100479,0,2017.csv,2017,100%,-
3964,Raw,3096815,514870,2581945,2017.csv,2017,16.6%,83.4%
3965,Paid in Full,3090862,3090862,0,2002.csv,2002,100%,-
3966,Aquarius,3085977,285930,2800047,2016.csv,2016,9.3%,90.7%
3967,The People Vs. Fritz Bauer,3083973,288483,2795490,2015.csv,2015,9.4%,90.6%
3968,Dhobi Ghat,3082958,576639,2506319,2011.csv,2011,18.7%,81.3%
3969,Incantato,3082196,108954,2973242,2003.csv,2003,3.5%,96.5%
3970,3 Hearts,3077754,161129,2916625,2014.csv,2014,5.2%,94.8%
3971,Ismael's Ghosts,3075562,102510,2973052,2017.csv,2017,3.3%,96.7%
3972,Living Is Easy with Eyes Closed,3075169,11600,3063569,2013.csv,2013,0.4%,99.6%
3973,The End of the Tour,3072991,3002884,70107,2015.csv,2015,97.7%,2.3%
3974,Jane Got a Gun,3067531,1513793,1553738,2015.csv,2015,49.3%,50.7%
3975,English Vinglish,3064818,1862086,1202732,2012.csv,2012,60.8%,39.2%
3976,'71,3062178,1270847,1791331,2014.csv,2014,41.5%,58.5%
3977,Remember,3054936,547009,2507927,2015.csv,2015,17.9%,82.1%
3978,Mambo Italiano,3047296,3047296,0,2003.csv,2003,100%,-
3979,La moustache,3044771,244771,2800000,2005.csv,2005,8%,92%
3980,The Mother,3039587,1063163,1976424,2003.csv,2003,35%,65%
3981,Harrison's Flowers,3033646,1871025,1162621,2002.csv,2002,61.7%,38.3%
3982,Innocence,3026796,2202382,824414,2001.csv,2001,72.8%,27.2%
3983,Starred Up,3025189,54915,2970274,2014.csv,2014,1.8%,98.2%
3984,G,3020784,3020784,0,2005.csv,2005,100%,-
3985,The Greatest Miracle,3019382,555166,2464216,2011.csv,2011,18.4%,81.6%
3986,All Is True,3019143,1200481,1818662,2019.csv,2019,39.8%,60.2%
3987,Top Gun 2013 3D Release,3018873,3018873,0,2013.csv,2013,100%,-
3988,Rigor Mortis,3016904,7865,3009039,2013.csv,2013,0.3%,99.7%
3989,Cowboy Bebop: The Movie,3007903,1000045,2007858,2003.csv,2003,33.2%,66.8%
3990,The Last Full Measure,3006059,2949212,56847,2020.csv,2020,98.1%,1.9%
3991,The Second Mother,3003560,376986,2626574,2015.csv,2015,12.6%,87.4%
3992,Isn't She Great,3003296,2962465,40831,2000.csv,2000,98.6%,1.4%
3993,The Imposter,3001877,898317,2103560,2012.csv,2012,29.9%,70.1%
3994,Made for More,2999134,2999134,0,2018.csv,2018,100%,-
3995,Pinocchio Italian Version,2995810,8586,2987224,2003.csv,2003,0.3%,99.7%
3996,The Corporation 2004 Re-release,2992149,1879983,1112166,2004.csv,2004,62.8%,37.2%
3997,Elsa & Fred,2985837,189024,2796813,2005.csv,2005,6.3%,93.7%
3998,The Last Word,2982004,1783421,1198583,2017.csv,2017,59.8%,40.2%
3999,Darwin's Nightmare,2981713,203746,2777967,2005.csv,2005,6.8%,93.2%
4000,Memoir of War,2980982,103636,2877346,2018.csv,2018,3.5%,96.5%
4001,Love Is Strange 2014 Re-release,2979739,2262223,717516,2014.csv,2014,75.9%,24.1%
4002,Clean,2971219,138711,2832508,2004.csv,2004,4.7%,95.3%
4003,Romeo & Juliet,2966268,1162635,1803633,2013.csv,2013,39.2%,60.8%
4004,Donnie Darko,2962988,517375,2445613,2001.csv,2001,17.5%,82.5%
4005,The Last: Naruto the Movie,2949185,524451,2424734,2015.csv,2015,17.8%,82.2%
4006,Shattered Glass,2944752,2220008,724744,2003.csv,2003,75.4%,24.6%
4007,Dabangg,2942554,1288549,1654005,2010.csv,2010,43.8%,56.2%
4008,Filly Brown,2940411,2850357,90054,2013.csv,2013,96.9%,3.1%
4009,Joan Rivers: A Piece of Work,2930687,2930687,0,2010.csv,2010,100%,-
4010,The Lord of the Rings: The Fellowship of the Ring 2003 Extended Edition,2928554,1412056,1516498,2002.csv,2002,48.2%,51.8%
4011,Kites,2924751,1643486,1281265,2010.csv,2010,56.2%,43.8%
4012,My Architect,2920081,2750707,169374,2003.csv,2003,94.2%,5.8%
4013,Sylvia,2917393,1315498,1601895,2003.csv,2003,45.1%,54.9%
4014,Brighton Rock,2913599,229653,2683946,2011.csv,2011,7.9%,92.1%
4015,Letters to God,2908893,2848578,60315,2010.csv,2010,97.9%,2.1%
4016,The Aeronauts,2907225,0,2907225,2019.csv,2019,-,100%
4017,Bright Young Things,2905499,933637,1971862,2003.csv,2003,32.1%,67.9%
4018,Time to Leave,2893462,117686,2775776,2005.csv,2005,4.1%,95.9%
4019,The East,2891812,2301839,589973,2013.csv,2013,79.6%,20.4%
4020,The Oscar Nominated Short Films 2017: Live Action,2877797,2835355,42442,2017.csv,2017,98.5%,1.5%
4021,Starbuck,2865068,340058,2525010,2011.csv,2011,11.9%,88.1%
4022,Home Run,2861020,2861020,0,2013.csv,2013,100%,-
4023,And Now... Ladies and Gentlemen...,2860785,736872,2123913,2002.csv,2002,25.8%,74.2%
4024,The Flowers of War,2855644,311434,2544210,2012.csv,2012,10.9%,89.1%
4025,Inhumans,2852282,1521787,1330495,2017.csv,2017,53.4%,46.6%
4026,The Salt of Life,2850852,317405,2533447,2011.csv,2011,11.1%,88.9%
4027,The Oscar Nominated Short Films 2016: Live Action,2850840,2816816,34024,2016.csv,2016,98.8%,1.2%
4028,God Bless the Broken Road,2848233,2846257,1976,2018.csv,2018,99.9%,<0.1%
4029,All or Nothing,2845696,201546,2644150,2002.csv,2002,7.1%,92.9%
4030,Remember You,2845124,14814,2830310,2016.csv,2016,0.5%,99.5%
4031,Children of the Sea,2843206,0,2843206,2019.csv,2019,-,100%
4032,Hold Your Breath,2842040,77987,2764053,2018.csv,2018,2.7%,97.3%
4033,The Identical,2840991,2827666,13325,2014.csv,2014,99.5%,0.5%
4034,Personal Shopper,2840408,1305195,1535213,2016.csv,2016,46%,54%
4035,The Fluffy Movie: Unity Through Laughter,2827393,2827393,0,2014.csv,2014,100%,-
4036,A Coffee in Berlin,2826333,150275,2676058,2012.csv,2012,5.3%,94.7%
4037,Everything Must Go,2820490,2711643,108847,2011.csv,2011,96.1%,3.9%
4038,Raising Victor Vargas,2816116,2078661,737455,2003.csv,2003,73.8%,26.2%
4039,Captive,2801508,2583301,218207,2015.csv,2015,92.2%,7.8%
4040,To the Wonder,2801166,587615,2213551,2013.csv,2013,21%,79%
4041,"Cinco de Mayo, La Batalla",2794852,173472,2621380,2013.csv,2013,6.2%,93.8%
4042,Bon voyage 2004 Re-release,2788330,2354559,433771,2004.csv,2004,84.4%,15.6%
4043,Saving Christmas,2783970,2783970,0,2014.csv,2014,100%,-
4044,24 Hour Party People,2781211,1184096,1597115,2002.csv,2002,42.6%,57.4%
4045,Gabrielle,2775311,332829,2442482,2005.csv,2005,12%,88%
4046,The Wonders,2772358,73378,2698980,2014.csv,2014,2.6%,97.4%
4047,My Summer of Love,2766976,1000915,1766061,2004.csv,2004,36.2%,63.8%
4048,Comedian,2751988,2751988,0,2002.csv,2002,100%,-
4049,Ma vie en cinémascope,2750263,2750263,0,2004.csv,2004,100%,-
4050,Battle for Incheon: Operation Chromite,2749918,1023348,1726570,2016.csv,2016,37.2%,62.8%
4051,Ararat,2743336,1555959,1187377,2002.csv,2002,56.7%,43.3%
4052,McQueen,2739246,1257275,1481971,2018.csv,2018,45.9%,54.1%
4053,Edie,2731170,71790,2659380,2018.csv,2018,2.6%,97.4%
4054,Lucky,2728446,955925,1772521,2017.csv,2017,35%,65%
4055,Control Room,2724826,2589616,135210,2004.csv,2004,95%,5%
4056,Cocktail,2724695,1227789,1496906,2012.csv,2012,45.1%,54.9%
4057,The Color of Paradise,2724595,1817216,907379,2000.csv,2000,66.7%,33.3%
4058,Chi-Raq,2719699,2653032,66667,2015.csv,2015,97.5%,2.5%
4059,Billionaire Boys Club,2713955,1349,2712606,2018.csv,2018,<0.1%,100%
4060,What Maisie Knew,2711379,1066471,1644908,2013.csv,2013,39.3%,60.7%
4061,Factotum,2708087,808221,1899866,2005.csv,2005,29.8%,70.2%
4062,Bobby Jones: Stroke of Genius,2707913,2694071,13842,2004.csv,2004,99.5%,0.5%
4063,Metallica & San Francisco Symphony - S&M2,2705442,1252385,1453057,2019.csv,2019,46.3%,53.7%
4064,Up and Down,2705163,245127,2460036,2004.csv,2004,9.1%,90.9%
4065,Auto Focus,2704951,2063196,641755,2002.csv,2002,76.3%,23.7%
4066,The Guest,2700051,332890,2367161,2014.csv,2014,12.3%,87.7%
4067,Gangsterdam,2697522,954,2696568,2017.csv,2017,<0.1%,100%
4068,After the Wedding,2694607,1574258,1120349,2019.csv,2019,58.4%,41.6%
4069,The Best of Youth,2693053,274024,2419029,2003.csv,2003,10.2%,89.8%
4070,Jiro Dreams of Sushi,2692864,2552478,140386,2012.csv,2012,94.8%,5.2%
4071,Thérèse: The Story of Saint Thérèse of Lisieux,2689828,2627016,62812,2004.csv,2004,97.7%,2.3%
4072,A Hijacking,2688444,414437,2274007,2012.csv,2012,15.4%,84.6%
4073,The Lodge,2679438,1666564,1012874,2020.csv,2020,62.2%,37.8%
4074,Intimacy,2672527,405094,2267433,2001.csv,2001,15.2%,84.8%
4075,In Your Name,2663172,0,2663172,2003.csv,2003,-,100%
4076,The Cup,2660645,0,2660645,2011.csv,2011,-,100%
4077,Diego Maradona,2656890,0,2656890,2019.csv,2019,-,100%
4078,Camp,2650356,1629862,1020494,2003.csv,2003,61.5%,38.5%
4079,Hillsong: Let Hope Rise,2649761,2394386,255375,2016.csv,2016,90.4%,9.6%
4080,Twelve,2648195,183920,2464275,2010.csv,2010,6.9%,93.1%
4081,Pioneer,2647820,6871,2640949,2013.csv,2013,0.3%,99.7%
4082,Stories We Tell,2641053,1600145,1040908,2013.csv,2013,60.6%,39.4%
4083,God's Army,2637726,2637726,0,2000.csv,2000,100%,-
4084,Kinky Boots: The Musical,2635571,900451,1735120,2019.csv,2019,34.2%,65.8%
4085,Beautiful Accident,2632092,51766,2580326,2017.csv,2017,2%,98%
4086,Maniac,2631275,31081,2600194,2012.csv,2012,1.2%,98.8%
4087,Third Person,2624761,1021398,1603363,2014.csv,2014,38.9%,61.1%
4088,Below,2622015,605562,2016453,2002.csv,2002,23.1%,76.9%
4089,The Happy Prince,2621992,466440,2155552,2018.csv,2018,17.8%,82.2%
4090,Happy End,2610794,301718,2309076,2017.csv,2017,11.6%,88.4%
4091,The Little Mermaid,2610742,147175,2463567,2018.csv,2018,5.6%,94.4%
4092,Russian Ark Canadian Release,2610711,684034,1926677,2003.csv,2003,26.2%,73.8%
4093,Poster Boys,2602256,97049,2505207,2017.csv,2017,3.7%,96.3%
4094,Zero,2595762,1035388,1560374,2018.csv,2018,39.9%,60.1%
4095,N-Secure,2595644,2595644,0,2010.csv,2010,100%,-
4096,The Signal,2595622,600896,1994726,2014.csv,2014,23.2%,76.8%
4097,But I'm a Cheerleader,2595216,2205627,389589,2000.csv,2000,85%,15%
4098,It's Easier for a Camel...,2590219,16150,2574069,2003.csv,2003,0.6%,99.4%
4099,Leo Da Vinci: Mission Mona Lisa,2588859,19978,2568881,2018.csv,2018,0.8%,99.2%
4100,A Question of Faith,2587072,2587072,0,2017.csv,2017,100%,-
4101,Blancanieves,2585522,279735,2305787,2012.csv,2012,10.8%,89.2%
4102,Assassination Nation,2584988,2005142,579846,2018.csv,2018,77.6%,22.4%
4103,The Gatekeepers,2573616,2415727,157889,2013.csv,2013,93.9%,6.1%
4104,Is Genesis History?,2570392,2570392,0,2017.csv,2017,100%,-
4105,Maquia: When the Promised Flower Blooms 2018 Re-release,2569927,18539,2551388,2018.csv,2018,0.7%,99.3%
4106,Blood Ties,2566435,42472,2523963,2013.csv,2013,1.7%,98.3%
4107,Young Adam,2561820,767373,1794447,2003.csv,2003,30%,70%
4108,God's Own Country,2559939,335609,2224330,2017.csv,2017,13.1%,86.9%
4109,Lucky Break,2559317,54606,2504711,2001.csv,2001,2.1%,97.9%
4110,The Only Living Boy in New York,2550321,624332,1925989,2017.csv,2017,24.5%,75.5%
4111,"1,000 Times Good Night",2549568,53895,2495673,2013.csv,2013,2.1%,97.9%
4112,Disney's Newsies: The Broadway Musical!,2545060,2545060,0,2017.csv,2017,100%,-
4113,The Dinner,2544921,1323312,1221609,2017.csv,2017,52%,48%
4114,El Jeremías,2540144,650465,1889679,2016.csv,2016,25.6%,74.4%
4115,In the Name of My Daughter,2537899,277528,2260371,2014.csv,2014,10.9%,89.1%
4116,Novocaine,2534372,2036682,497690,2001.csv,2001,80.4%,19.6%
4117,IN OUR HANDS: Battle for Jerusalem,2534370,2534370,0,2017.csv,2017,100%,-
4118,Poetry,2533089,356149,2176940,2010.csv,2010,14.1%,85.9%
4119,Spirits in the Forest,2531785,704744,1827041,2019.csv,2019,27.8%,72.2%
4120,Bucky Larson: Born to Be a Star,2530394,2529395,999,2011.csv,2011,100%,<0.1%
4121,Coincidence,2520487,298032,2222455,2017.csv,2017,11.8%,88.2%
4122,Restless,2518012,163265,2354747,2011.csv,2011,6.5%,93.5%
4123,Birds of Passage,2517349,507259,2010090,2018.csv,2018,20.2%,79.8%
4124,Fateless,2512009,196857,2315152,2005.csv,2005,7.8%,92.2%
4125,LBJ,2510151,2470979,39172,2017.csv,2017,98.4%,1.6%
4126,The Rover,2510007,1114423,1395584,2014.csv,2014,44.4%,55.6%
4127,Grace Unplugged,2507201,2507201,0,2013.csv,2013,100%,-
4128,I'm in Love with a Church Girl,2503392,2387730,115662,2013.csv,2013,95.4%,4.6%
4129,The Queen of Versailles,2495706,2401999,93707,2012.csv,2012,96.2%,3.8%
4130,Still Life,2495025,9481,2485544,2013.csv,2013,0.4%,99.6%
4131,Look Both Ways,2490011,105067,2384944,2005.csv,2005,4.2%,95.8%
4132,Polaroid,2489778,0,2489778,2019.csv,2019,-,100%
4133,"One Nation, One King",2481681,6576,2475105,2018.csv,2018,0.3%,99.7%
4134,Cairo Time,2477315,1603616,873699,2010.csv,2010,64.7%,35.3%
4135,The Christmas Candle,2476775,2258620,218155,2013.csv,2013,91.2%,8.8%
4136,Wonderland,2466444,1060512,1405932,2003.csv,2003,43%,57%
4137,Bamboozled,2463650,2274979,188671,2000.csv,2000,92.3%,7.7%
4138,Last Days,2456454,463080,1993374,2005.csv,2005,18.9%,81.1%
4139,Painted Skin: The Resurrection,2455359,50425,2404934,2012.csv,2012,2.1%,97.9%
4140,Tees Maar Khan,2454414,1076443,1377971,2010.csv,2010,43.9%,56.1%
4141,The Endurance,2453083,2453083,0,2001.csv,2001,100%,-
4142,Piku,2452343,1801807,650536,2015.csv,2015,73.5%,26.5%
4143,Crime Spree,2451607,0,2451607,2003.csv,2003,-,100%
4144,Footnote,2451259,2007758,443501,2011.csv,2011,81.9%,18.1%
4145,The Tree,2450045,71158,2378887,2010.csv,2010,2.9%,97.1%
4146,Côte d'Azur,2447211,141039,2306172,2005.csv,2005,5.8%,94.2%
4147,Love at First Fight,2446362,25229,2421133,2014.csv,2014,1%,99%
4148,Lean on Pete,2443584,1163056,1280528,2018.csv,2018,47.6%,52.4%
4149,Highwaymen,2442378,371396,2070982,2004.csv,2004,15.2%,84.8%
4150,The Informer,2441411,0,2441411,2019.csv,2019,-,100%
4151,Coriolanus,2435325,757195,1678130,2012.csv,2012,31.1%,68.9%
4152,The Unknown Girl,2432640,150549,2282091,2016.csv,2016,6.2%,93.8%
4153,Joe,2431443,373375,2058068,2014.csv,2014,15.4%,84.6%
4154,The Grace Card,2430735,2430735,0,2011.csv,2011,100%,-
4155,The Breadwinner 2018 Re-release,2426907,834,2426073,2018.csv,2018,<0.1%,100%
4156,Life of Riley,2423379,11616,2411763,2014.csv,2014,0.5%,99.5%
4157,The Matrix Reloaded 2003 IMAX Release,2423288,0,2423288,2003.csv,2003,-,100%
4158,After.Life,2422634,108595,2314039,2010.csv,2010,4.5%,95.5%
4159,Adam's Apples,2421577,1305,2420272,2005.csv,2005,<0.1%,99.9%
4160,Hearts Beat Loud,2417165,2386251,30914,2018.csv,2018,98.7%,1.3%
4161,Paheli,2415975,1409499,1006476,2005.csv,2005,58.3%,41.7%
4162,The Art of Self-Defense,2414269,2410914,3355,2019.csv,2019,99.9%,0.1%
4163,The Oscar Nominated Short Films 2015: Live Action,2412593,2412593,0,2015.csv,2015,100%,-
4164,Beloved Sisters,2407680,54030,2353650,2014.csv,2014,2.2%,97.8%
4165,Sound! Euphonium the Movie - Our Promise: A Brand New Day,2403030,90341,2312689,2019.csv,2019,3.8%,96.2%
4166,The Stroller Strategy,2401291,3462,2397829,2013.csv,2013,0.1%,99.9%
4167,Waqt: The Race Against Time,2395616,815064,1580552,2005.csv,2005,34%,66%
4168,The Man Who Killed Don Quixote,2390383,391963,1998420,2018.csv,2018,16.4%,83.6%
4169,Twilight/The Twilight Saga: New Moon,2385237,2385237,0,2010.csv,2010,100%,-
4170,Finding Vivian Maier,2384584,1514782,869802,2014.csv,2014,63.5%,36.5%
4171,Dark Blue World,2381183,258771,2122412,2001.csv,2001,10.9%,89.1%
4172,Laggies,2379154,1066981,1312173,2014.csv,2014,44.8%,55.2%
4173,Journey,2377609,2377609,0,2003.csv,2003,100%,-
4174,Red Lights,2373828,673828,1700000,2004.csv,2004,28.4%,71.6%
4175,I Wish,2371548,145808,2225740,2011.csv,2011,6.1%,93.9%
4176,Lore,2362019,970325,1391694,2012.csv,2012,41.1%,58.9%
4177,Cake,2360281,1951776,408505,2015.csv,2015,82.7%,17.3%
4178,Desi Boyz,2355293,1078826,1276467,2011.csv,2011,45.8%,54.2%
4179,Chico & Rita,2347919,350524,1997395,2010.csv,2010,14.9%,85.1%
4180,Memories of the Sword,2345062,111071,2233991,2015.csv,2015,4.7%,95.3%
4181,Standing in the Shadows of Motown,2344256,1722119,622137,2002.csv,2002,73.5%,26.5%
4182,Terraferma,2343302,19996,2323306,2011.csv,2011,0.9%,99.1%
4183,1991,2342264,2342264,0,2018.csv,2018,100%,-
4184,Housefull,2340550,1183658,1156892,2010.csv,2010,50.6%,49.4%
4185,Ong-bak 3,2340516,14890,2325626,2010.csv,2010,0.6%,99.4%
4186,High Heels and Low Lifes,2340411,228194,2112217,2001.csv,2001,9.8%,90.2%
4187,Gabriela,2335352,2335352,0,2001.csv,2001,100%,-
4188,Meru,2334228,2334228,0,2015.csv,2015,100%,-
4189,Jem and the Holograms,2333684,2184640,149044,2015.csv,2015,93.6%,6.4%
4190,Ready,2332914,955148,1377766,2011.csv,2011,40.9%,59.1%
4191,The Experiment 2002 Re-release,2327755,144634,2183121,2002.csv,2002,6.2%,93.8%
4192,Bhaag Milkha Bhaag,2325917,1636731,689186,2013.csv,2013,70.4%,29.6%
4193,The Oranges,2316971,366377,1950594,2012.csv,2012,15.8%,84.2%
4194,Austenland,2313509,2159041,154468,2013.csv,2013,93.3%,6.7%
4195,A Aa,2313043,2313043,0,2016.csv,2016,100%,-
4196,WARx2,2310625,2310625,0,2015.csv,2015,100%,-
4197,The Resurrection of Gavin Stone,2308355,2303792,4563,2017.csv,2017,99.8%,0.2%
4198,Blackfish,2303417,2073582,229835,2013.csv,2013,90%,10%
4199,Lost Embrace,2298732,190860,2107872,2004.csv,2004,8.3%,91.7%
4200,Piranhas,2298525,23494,2275031,2019.csv,2019,1%,99%
4201,The Remaining,2297261,1169603,1127658,2014.csv,2014,50.9%,49.1%
4202,3 from Hell,2295825,2172949,122876,2019.csv,2019,94.6%,5.4%
4203,Buffalo Soldiers,2295274,354421,1940853,2002.csv,2002,15.4%,84.6%
4204,Ek Main Aur Ekk Tu,2293823,1155545,1138278,2012.csv,2012,50.4%,49.6%
4205,Going Away,2290889,19501,2271388,2014.csv,2014,0.9%,99.1%
4206,American Honey,2290649,663246,1627403,2016.csv,2016,29%,71%
4207,Noel,2280924,0,2280924,2004.csv,2004,-,100%
4208,Escanaba in da Moonlight,2276602,2276602,0,2001.csv,2001,100%,-
4209,RV: Resurrected Victims,2269892,20374,2249518,2017.csv,2017,0.9%,99.1%
4210,The House That Jack Built 2018 Re-release,2268855,87993,2180862,2018.csv,2018,3.9%,96.1%
4211,Luce,2268204,2010613,257591,2019.csv,2019,88.6%,11.4%
4212,Sleepwalk with Me,2266067,2266067,0,2012.csv,2012,100%,-
4213,Nobody Knows,2265264,684118,1581146,2004.csv,2004,30.2%,69.8%
4214,Puzzle,2260946,2032018,228928,2018.csv,2018,89.9%,10.1%
4215,Dans une galaxie près de chez vous - Le film,2259688,2259688,0,2004.csv,2004,100%,-
4216,DysFunktional Family,2255000,2255000,0,2003.csv,2003,100%,-
4217,Shadow Dancer,2253819,100616,2153203,2012.csv,2012,4.5%,95.5%
4218,An Interview with God,2251795,1201434,1050361,2018.csv,2018,53.4%,46.6%
4219,Marius,2249781,9781,2240000,2013.csv,2013,0.4%,99.6%
4220,My All-American,2246000,2246000,0,2015.csv,2015,100%,-
4221,No culpes al karma de lo que te pasa por gilipollas,2242471,5614,2236857,2016.csv,2016,0.3%,99.7%
4222,At War,2235052,4605,2230447,2018.csv,2018,0.2%,99.8%
4223,Elena,2227905,233380,1994525,2011.csv,2011,10.5%,89.5%
4224,Heal the Living,2223529,3176,2220353,2016.csv,2016,0.1%,99.9%
4225,The Lovers,2216083,2194521,21562,2017.csv,2017,99%,1%
4226,Bill Cunningham: New York,2210382,1510026,700356,2011.csv,2011,68.3%,31.7%
4227,Rivers and Tides: Andy Goldsworthy Working with Time,2200276,2200276,0,2002.csv,2002,100%,-
4228,Goodnight Mommy,2193474,1178196,1015278,2015.csv,2015,53.7%,46.3%
4229,3 Faces,2191516,72324,2119192,2018.csv,2018,3.3%,96.7%
4230,What Will People Say,2191131,44156,2146975,2017.csv,2017,2%,98%
4231,Maria By Callas 2018 Re-release,2185562,1267301,918261,2018.csv,2018,58%,42%
4232,Kuch Naa Kaho,2185360,224831,1960529,2003.csv,2003,10.3%,89.7%
4233,Anchorman 2: The Legend Continues R-Rated Extended Cut,2185255,2184339,916,2014.csv,2014,100%,<0.1%
4234,Border,2177678,771930,1405748,2018.csv,2018,35.4%,64.6%
4235,Gone with the Wind 2019 Re-release,2176120,2176120,0,2019.csv,2019,100%,-
4236,Veere Di Wedding,2176099,0,2176099,2018.csv,2018,-,100%
4237,Armaan,2174005,301010,1872995,2003.csv,2003,13.8%,86.2%
4238,The Oscar Nominated Short Films 2014: Live Action,2171849,2171849,0,2014.csv,2014,100%,-
4239,Henry's Crime,2169799,102541,2067258,2011.csv,2011,4.7%,95.3%
4240,The Reluctant Fundamentalist,2167020,552959,1614061,2013.csv,2013,25.5%,74.5%
4241,The Benefactor,2159380,0,2159380,2015.csv,2015,-,100%
4242,Stage Beauty,2153070,782383,1370687,2004.csv,2004,36.3%,63.7%
4243,Shower,2150929,1157764,993165,2000.csv,2000,53.8%,46.2%
4244,The Saratov Approach,2146999,2146999,0,2013.csv,2013,100%,-
4245,The Oscar Nominated Short Films 2013: Live Action,2142342,2142342,0,2013.csv,2013,100%,-
4246,Let Yourself Go,2140190,12189,2128001,2017.csv,2017,0.6%,99.4%
4247,The Attack,2139516,1720325,419191,2013.csv,2013,80.4%,19.6%
4248,Thumbsucker,2138742,1328679,810063,2005.csv,2005,62.1%,37.9%
4249,High Life,2133033,1225852,907181,2018.csv,2018,57.5%,42.5%
4250,My Scientology Movie,2130866,22936,2107930,2016.csv,2016,1.1%,98.9%
4251,Mountain,2129889,365412,1764477,2017.csv,2017,17.2%,82.8%
4252,Heleno,2126384,0,2126384,2012.csv,2012,-,100%
4253,Sightseers,2122909,61782,2061127,2012.csv,2012,2.9%,97.1%
4254,Jai Ho,2122804,1264515,858289,2014.csv,2014,59.6%,40.4%
4255,Abracadabra,2114260,13975,2100285,2017.csv,2017,0.7%,99.3%
4256,Left Luggage,2111280,1069540,1041740,2000.csv,2000,50.7%,49.3%
4257,State Property,2106838,2106838,0,2002.csv,2002,100%,-
4258,"20,000 Days on Earth",2105558,279558,1826000,2014.csv,2014,13.3%,86.7%
4259,The Eye of the Storm,2104689,83566,2021123,2011.csv,2011,4%,96%
4260,Once Upon a Time in Anatolia,2099472,152408,1947064,2011.csv,2011,7.3%,92.7%
4261,Indian Horse,2097362,2097362,0,2018.csv,2018,100%,-
4262,Mary Shelley,2096600,108900,1987700,2018.csv,2018,5.2%,94.8%
4263,Bollywood/Hollywood,2092228,1454510,637718,2002.csv,2002,69.5%,30.5%
4264,Garam Masala,2091698,1007943,1083755,2005.csv,2005,48.2%,51.8%
4265,The Captive,2090612,1075178,1015434,2014.csv,2014,51.4%,48.6%
4266,"The Butcher, the Chef, and the Swordsman",2089266,47896,2041370,2011.csv,2011,2.3%,97.7%
4267,Apollo 13 The IMAX Experience,2089051,1766621,322430,2002.csv,2002,84.6%,15.4%
4268,Girl Most Likely,2085617,1378591,707026,2013.csv,2013,66.1%,33.9%
4269,The Hard Word,2085562,426880,1658682,2002.csv,2002,20.5%,79.5%
4270,Summer Storm,2085166,95204,1989962,2004.csv,2004,4.6%,95.4%
4271,Equals,2084628,33258,2051370,2016.csv,2016,1.6%,98.4%
4272,High Strung,2084451,53447,2031004,2016.csv,2016,2.6%,97.4%
4273,I'm Not Ashamed,2082980,2082980,0,2016.csv,2016,100%,-
4274,Lost in Paris,2082381,691597,1390784,2017.csv,2017,33.2%,66.8%
4275,A Cat in Paris,2080634,309973,1770661,2010.csv,2010,14.9%,85.1%
4276,The Wizard of Oz 2019 Re-release,2076020,2076020,0,2019.csv,2019,100%,-
4277,Dangerous Liaisons,2074864,54000,2020864,2012.csv,2012,2.6%,97.4%
4278,Black '47,2073063,57520,2015543,2018.csv,2018,2.8%,97.2%
4279,Blood Simple 2000 Re-release,2068701,1701855,366846,2000.csv,2000,82.3%,17.7%
4280,A Fool,2067820,8212,2059608,2015.csv,2015,0.4%,99.6%
4281,Golmaal 3,2067671,1132192,935479,2010.csv,2010,54.8%,45.2%
4282,American Pastoral,2063436,544098,1519338,2016.csv,2016,26.4%,73.6%
4283,Golmaal Again,2057329,1013893,1043436,2017.csv,2017,49.3%,50.7%
4284,Battle of the Brave,2057293,1599716,457577,2004.csv,2004,77.8%,22.2%
4285,Under the Silver Lake,2053469,46083,2007386,2018.csv,2018,2.2%,97.8%
4286,Viruddh... Family Comes First,2048588,327615,1720973,2005.csv,2005,16%,84%
4287,Hamlet,2046433,1577287,469146,2000.csv,2000,77.1%,22.9%
4288,Being 17,2045219,52713,1992506,2016.csv,2016,2.6%,97.4%
4289,Guzaarish,2043580,1017335,1026245,2010.csv,2010,49.8%,50.2%
4290,W.E.,2042203,583455,1458748,2012.csv,2012,28.6%,71.4%
4291,The Dangerous Lives of Altar Boys,2036599,1815864,220735,2002.csv,2002,89.2%,10.8%
4292,Raid,2031135,1010385,1020750,2018.csv,2018,49.7%,50.3%
4293,Waves,2027629,1658790,368839,2019.csv,2019,81.8%,18.2%
4294,Climax,2027391,817339,1210052,2018.csv,2018,40.3%,59.7%
4295,The Work and the Glory II: American Zion,2025032,2025032,0,2005.csv,2005,100%,-
4296,The Broken Hearts Club: A Romantic Comedy,2019121,1746585,272536,2000.csv,2000,86.5%,13.5%
4297,Armadillo,2018685,14566,2004119,2010.csv,2010,0.7%,99.3%
4298,Graduation,2015002,175975,1839027,2016.csv,2016,8.7%,91.3%
4299,What to Do in Case of Fire,2014162,33545,1980617,2002.csv,2002,1.7%,98.3%
4300,Sur le seuil,2014071,2014071,0,2003.csv,2003,100%,-
4301,Little Men,2008649,702537,1306112,2016.csv,2016,35%,65%
4302,The Man from Elysian Fields,2006391,1435016,571375,2002.csv,2002,71.5%,28.5%
4303,Red Nose,2004814,2004814,0,2003.csv,2003,100%,-
4304,Greater,2000093,2000093,0,2016.csv,2016,100%,-
4305,Peterloo,1998945,151971,1846974,2018.csv,2018,7.6%,92.4%
4306,Mujhse Shaadi Karogi,1998096,915728,1082368,2004.csv,2004,45.8%,54.2%
4307,1898: Our Last Men in the Philippines,1995045,2848,1992197,2016.csv,2016,0.1%,99.9%
4308,Antboy,1994566,0,1994566,2013.csv,2013,-,100%
4309,Va Savoir (Who Knows?),1989779,907323,1082456,2001.csv,2001,45.6%,54.4%
4310,The Trip to Spain,1988841,1157604,831237,2017.csv,2017,58.2%,41.8%
4311,Summer 1993,1983149,185903,1797246,2017.csv,2017,9.4%,90.6%
4312,The Metropolitan Opera HD Live: Verdi: La Traviata,1982588,1882931,99657,2018.csv,2018,95%,5%
4313,Metallica: Some Kind of Monster,1980444,1222708,757736,2004.csv,2004,61.7%,38.3%
4314,Maquia: When the Promised Flower Blooms,1979604,185699,1793905,2018.csv,2018,9.4%,90.6%
4315,Singham Returns,1974745,1232018,742727,2014.csv,2014,62.4%,37.6%
4316,Beloved,1971858,137515,1834343,2011.csv,2011,7%,93%
4317,Diary of a Chambermaid,1971247,54235,1917012,2015.csv,2015,2.8%,97.2%
4318,42nd Street: The Musical,1967450,187440,1780010,2019.csv,2019,9.5%,90.5%
4319,Menashe,1962265,1703036,259229,2017.csv,2017,86.8%,13.2%
4320,Cecil B. DeMented,1961544,1284646,676898,2000.csv,2000,65.5%,34.5%
4321,Greenfingers,1961054,1443067,517987,2001.csv,2001,73.6%,26.4%
4322,Holy Motors,1954125,641100,1313025,2012.csv,2012,32.8%,67.2%
4323,Swades,1953889,1223240,730649,2004.csv,2004,62.6%,37.4%
4324,God Is Great and I'm Not,1952817,73181,1879636,2001.csv,2001,3.7%,96.3%
4325,A Ghost Story,1951683,1596371,355312,2017.csv,2017,81.8%,18.2%
4326,Beanpole,1950414,196258,1754156,2019.csv,2019,10.1%,89.9%
4327,Deadfall,1946254,66351,1879903,2012.csv,2012,3.4%,96.6%
4328,Liam,1945689,1016021,929668,2001.csv,2001,52.2%,47.8%
4329,V/H/S,1944287,100345,1843942,2012.csv,2012,5.2%,94.8%
4330,Housefull 3,1944262,1326999,617263,2016.csv,2016,68.3%,31.7%
4331,Another Earth,1938783,1321194,617589,2011.csv,2011,68.1%,31.9%
4332,Monty Python and the Holy Grail 2001 Re-release,1935066,1827696,107370,2001.csv,2001,94.5%,5.5%
4333,Roger Dodger,1934497,1266828,667669,2002.csv,2002,65.5%,34.5%
4334,Luka Chuppi,1923586,1042905,880681,2019.csv,2019,54.2%,45.8%
4335,Jane,1921221,1723379,197842,2017.csv,2017,89.7%,10.3%
4336,A Dirty Shame,1914166,1339668,574498,2004.csv,2004,70%,30%
4337,Old Fashioned,1914090,1914090,0,2015.csv,2015,100%,-
4338,Professor Marston & the Wonder Women,1899615,1584759,314856,2017.csv,2017,83.4%,16.6%
4339,Secuestro express,1898606,307208,1591398,2005.csv,2005,16.2%,83.8%
4340,Frank,1897363,645186,1252177,2014.csv,2014,34%,66%
4341,Game of Thrones Season 4 Finale,1896092,1896092,0,2015.csv,2015,100%,-
4342,The Art of Getting By,1892130,1430241,461889,2011.csv,2011,75.6%,24.4%
4343,The Mighty Macs,1891936,1891936,0,2011.csv,2011,100%,-
4344,Awake: The Life of Yogananda,1891918,1539680,352238,2014.csv,2014,81.4%,18.6%
4345,Red Lips,1889869,136163,1753706,2011.csv,2011,7.2%,92.8%
4346,Marie Curie: The Courage of Knowledge,1888501,127986,1760515,2017.csv,2017,6.8%,93.2%
4347,Tusk,1882074,1826705,55369,2014.csv,2014,97.1%,2.9%
4348,Hum Tum,1878702,796641,1082061,2004.csv,2004,42.4%,57.6%
4349,Kill Your Darlings,1877924,1030064,847860,2013.csv,2013,54.9%,45.1%
4350,Red State,1874460,1104682,769778,2011.csv,2011,58.9%,41.1%
4351,Wilbur Wants to Kill Himself,1873482,235294,1638188,2003.csv,2003,12.6%,87.4%
4352,Last Flag Flying,1872950,965481,907469,2017.csv,2017,51.5%,48.5%
4353,The Whistleblower,1870392,1124966,745426,2011.csv,2011,60.1%,39.9%
4354,Undertaking Betty,1868949,0,1868949,2002.csv,2002,-,100%
4355,Purple Rain 2016 Re-release,1868929,1868075,854,2016.csv,2016,100%,<0.1%
4356,Late Marriage,1868298,1656445,211853,2001.csv,2001,88.7%,11.3%
4357,The Luzhin Defence,1864747,1053070,811677,2001.csv,2001,56.5%,43.5%
4358,Inseparables,1864605,6258,1858347,2016.csv,2016,0.3%,99.7%
4359,A Better Life,1863506,1759252,104254,2011.csv,2011,94.4%,5.6%
4360,Girlhood,1862990,60765,1802225,2014.csv,2014,3.3%,96.7%
4361,The Hallow,1862407,13906,1848501,2015.csv,2015,0.7%,99.3%
4362,The Dark Horse,1862114,67533,1794581,2014.csv,2014,3.6%,96.4%
4363,The Pact,1855647,2488,1853159,2018.csv,2018,0.1%,99.9%
4364,The Five of Us,1852272,1852272,0,2004.csv,2004,100%,-
4365,Fantastic Fungi,1849050,1788322,60728,2019.csv,2019,96.7%,3.3%
4366,Sweet Country,1847693,104297,1743396,2018.csv,2018,5.6%,94.4%
4367,A Love Song for Bobby Long,1841260,164308,1676952,2004.csv,2004,8.9%,91.1%
4368,Elvis Gratton 3: Le retour d'Elvis Wong,1838920,1838920,0,2004.csv,2004,100%,-
4369,Crooked Arrows,1832541,1832541,0,2012.csv,2012,100%,-
4370,Startup.com,1830008,1283356,546652,2001.csv,2001,70.1%,29.9%
4371,99 Homes,1828232,1411927,416305,2015.csv,2015,77.2%,22.8%
4372,Enduring Love,1828184,358362,1469822,2004.csv,2004,19.6%,80.4%
4373,Rams,1826583,149250,1677333,2015.csv,2015,8.2%,91.8%
4374,A Somewhat Gentle Man,1826459,37743,1788716,2010.csv,2010,2.1%,97.9%
4375,Delhi Safari,1826376,0,1826376,2012.csv,2012,-,100%
4376,The Little Stranger,1824902,713143,1111759,2018.csv,2018,39.1%,60.9%
4377,Mozart's Sister,1824891,707885,1117006,2010.csv,2010,38.8%,61.2%
4378,Infinitely Polar Bear,1824678,1430655,394023,2015.csv,2015,78.4%,21.6%
4379,Human Flow,1824537,527845,1296692,2017.csv,2017,28.9%,71.1%
4380,The Seagull,1820461,1252960,567501,2018.csv,2018,68.8%,31.2%
4381,Song to Song,1813168,443684,1369484,2017.csv,2017,24.5%,75.5%
4382,Brodeuses - A Common Thread,1812833,26042,1786791,2004.csv,2004,1.4%,98.6%
4383,The Monk,1809527,13472,1796055,2011.csv,2011,0.7%,99.3%
4384,NSync: Bigger Than Live,1808679,1808679,0,2001.csv,2001,100%,-
4385,The Navigators,1807686,3052,1804634,2002.csv,2002,0.2%,99.8%
4386,The Other Side of Heaven 2: Fire of Faith,1807216,1807216,0,2019.csv,2019,100%,-
4387,Moses,1807117,1807117,0,2018.csv,2018,100%,-
4388,The Face of Love,1806548,350006,1456542,2013.csv,2013,19.4%,80.6%
4389,The Aura,1805261,58804,1746457,2005.csv,2005,3.3%,96.7%
4390,How I Killed My Father,1802142,145396,1656746,2001.csv,2001,8.1%,91.9%
4391,Oyster Farmer,1801199,15456,1785743,2005.csv,2005,0.9%,99.1%
4392,The Bridge of San Luis Rey,1800141,49981,1750160,2004.csv,2004,2.8%,97.2%
4393,Elvis & Nixon,1798432,1055287,743145,2016.csv,2016,58.7%,41.3%
4394,The Polar Express 2010 IMAX Release,1798274,672796,1125478,2010.csv,2010,37.4%,62.6%
4395,Mine,1788934,0,1788934,2016.csv,2016,-,100%
4396,Mondovino,1788325,209618,1578707,2004.csv,2004,11.7%,88.3%
4397,Harry Potter IMAX Marathon,1784557,1729226,55331,2016.csv,2016,96.9%,3.1%
4398,Soldiers of Fortune,1784286,38898,1745388,2012.csv,2012,2.2%,97.8%
4399,Ondine,1777019,550472,1226547,2010.csv,2010,31%,69%
4400,Tom of Finland,1776931,378296,1398635,2017.csv,2017,21.3%,78.7%
4401,The Diary of a Teenage Girl,1775133,1477002,298131,2015.csv,2015,83.2%,16.8%
4402,Dior and I,1769832,1028953,740879,2015.csv,2015,58.1%,41.9%
4403,I Saw the Light,1767963,1646788,121175,2016.csv,2016,93.1%,6.9%
4404,Carman: The Champion,1765751,1765751,0,2001.csv,2001,100%,-
4405,The Metropolitan Opera HD Live: Puccini: La Bohème,1764201,1764201,0,2018.csv,2018,100%,-
4406,Tales of the Night,1762194,10975,1751219,2011.csv,2011,0.6%,99.4%
4407,Bloody Sunday,1758689,773228,985461,2002.csv,2002,44%,56%
4408,Trolls World Tour,1758185,0,1758185,2020.csv,2020,-,100%
4409,The Blue Butterfly,1755355,1755355,0,2004.csv,2004,100%,-
4410,Flipped,1755212,1755212,0,2010.csv,2010,100%,-
4411,Going the Distance,1752950,1230897,522053,2004.csv,2004,70.2%,29.8%
4412,Murderball,1750211,1531154,219057,2005.csv,2005,87.5%,12.5%
4413,The Metropolitan Opera HD Live: Massenet: Cendrillon,1747259,1243306,503953,2018.csv,2018,71.2%,28.8%
4414,The Debut,1745778,1745778,0,2001.csv,2001,100%,-
4415,Beast,1744071,800365,943706,2018.csv,2018,45.9%,54.1%
4416,"Turn Me On, Dammit!",1743743,126085,1617658,2011.csv,2011,7.2%,92.8%
4417,Wuthering Heights,1742215,100915,1641300,2011.csv,2011,5.8%,94.2%
4418,L'odyssée d'Alice Tremblay,1734925,1734925,0,2002.csv,2002,100%,-
4419,First Position,1730824,1014071,716753,2012.csv,2012,58.6%,41.4%
4420,After Love,1728251,13693,1714558,2016.csv,2016,0.8%,99.2%
4421,Elling,1727470,314729,1412741,2001.csv,2001,18.2%,81.8%
4422,Girl Rising,1727259,1727259,0,2013.csv,2013,100%,-
4423,Diana Vreeland: The Eye Has to Travel,1721472,1017579,703893,2012.csv,2012,59.1%,40.9%
4424,A Faithful Man,1720605,77491,1643114,2018.csv,2018,4.5%,95.5%
4425,The Souvenir,1719157,1036737,682420,2019.csv,2019,60.3%,39.7%
4426,Invisible Life,1716237,146535,1569702,2019.csv,2019,8.5%,91.5%
4427,Weiner,1715955,1676108,39847,2016.csv,2016,97.7%,2.3%
4428,Safe Conduct,1713421,25440,1687981,2002.csv,2002,1.5%,98.5%
4429,The Life and Times of Hank Greenberg,1712385,1712385,0,2000.csv,2000,100%,-
4430,Grease 2018 Re-release,1710727,1213413,497314,2018.csv,2018,70.9%,29.1%
4431,"To Joey, with Love",1709073,1709073,0,2016.csv,2016,100%,-
4432,Paradise: Love,1709036,24267,1684769,2012.csv,2012,1.4%,98.6%
4433,The Girl on the Bridge,1708839,1708839,0,2000.csv,2000,100%,-
4434,"Men, Women & Children",1705908,705908,1000000,2014.csv,2014,41.4%,58.6%
4435,The Oscar Nominated Short Films 2012: Live Action,1702415,1702415,0,2012.csv,2012,100%,-
4436,Meet the Patels,1700681,1700681,0,2015.csv,2015,100%,-
4437,Rear Window 2000 Re-release,1699210,1574607,124603,2000.csv,2000,92.7%,7.3%
4438,Tekken,1697207,0,1697207,2010.csv,2010,-,100%
4439,Matthias & Maxime,1696938,374739,1322199,2019.csv,2019,22.1%,77.9%
4440,The Wild Pear Tree,1696258,34014,1662244,2018.csv,2018,2%,98%
4441,Dunkirk 2017 Re-release,1695119,1695119,0,2017.csv,2017,100%,-
4442,Open Hearts,1692272,136170,1556102,2002.csv,2002,8%,92%
4443,State Property: Blood on the Streets,1691706,1691706,0,2005.csv,2005,100%,-
4444,El vacilón: The Movie,1690929,1291951,398978,2005.csv,2005,76.4%,23.6%
4445,The Legend of Johnny Lingo,1690767,1690767,0,2003.csv,2003,100%,-
4446,All Good Things 2010 Re-release,1689646,582024,1107622,2010.csv,2010,34.4%,65.6%
4447,Slamma Jamma,1687000,1687000,0,2017.csv,2017,100%,-
4448,Tim's Vermeer,1686917,1671377,15540,2014.csv,2014,99.1%,0.9%
4449,Janis: Little Girl Blue,1683166,410465,1272701,2015.csv,2015,24.4%,75.6%
4450,The Bride,1682689,0,1682689,2015.csv,2015,-,100%
4451,Detachment,1681521,72689,1608832,2012.csv,2012,4.3%,95.7%
4452,The Hunter,1680778,176669,1504109,2011.csv,2011,10.5%,89.5%
4453,"The Book of Mormon Movie, Volume 1: The Journey",1680020,1680020,0,2003.csv,2003,100%,-
4454,In Between,1679952,107977,1571975,2016.csv,2016,6.4%,93.6%
4455,Final Portrait,1677835,461972,1215863,2017.csv,2017,27.5%,72.5%
4456,Marci X,1675706,1648818,26888,2003.csv,2003,98.4%,1.6%
4457,Nothing Left to Fear,1675381,7886,1667495,2013.csv,2013,0.5%,99.5%
4458,Ginger & Rosa,1674776,1012973,661803,2012.csv,2012,60.5%,39.5%
4459,Happy Endings,1673288,1315701,357587,2005.csv,2005,78.6%,21.4%
4460,Equity,1672306,1605463,66843,2016.csv,2016,96%,4%
4461,Divine Intervention,1672044,421343,1250701,2002.csv,2002,25.2%,74.8%
4462,La femme de mon frère,1671969,539524,1132445,2019.csv,2019,32.3%,67.7%
4463,Vanishing on 7th Street,1671196,22729,1648467,2011.csv,2011,1.4%,98.6%
4464,L.I.E.,1667192,1138836,528356,2001.csv,2001,68.3%,31.7%
4465,Girlfight,1666028,1565852,100176,2000.csv,2000,94%,6%
4466,A Hard Day's Night,1664617,965351,699266,2000.csv,2000,58%,42%
4467,The Double,1662515,200406,1462109,2014.csv,2014,12.1%,87.9%
4468,The Comedian,1659002,1659002,0,2016.csv,2016,100%,-
4469,Rustom,1658594,1087419,571175,2016.csv,2016,65.6%,34.4%
4470,Dear Frankie,1656829,18025,1638804,2005.csv,2005,1.1%,98.9%
4471,Deerskin,1656279,0,1656279,2019.csv,2019,-,100%
4472,Rockstar,1651601,986697,664904,2011.csv,2011,59.7%,40.3%
4473,What's Cooking?,1649655,1045899,603756,2000.csv,2000,63.4%,36.6%
4474,Two Lives,1649260,22620,1626640,2012.csv,2012,1.4%,98.6%
4475,Appleseed,1647770,129135,1518635,2004.csv,2004,7.8%,92.2%
4476,Dough,1647429,1148304,499125,2016.csv,2016,69.7%,30.3%
4477,The Letters,1647416,1647416,0,2015.csv,2015,100%,-
4478,The Little Hours,1647175,1647175,0,2017.csv,2017,100%,-
4479,Short Term 12,1645164,1013100,632064,2013.csv,2013,61.6%,38.4%
4480,Asylum,1644363,375403,1268960,2005.csv,2005,22.8%,77.2%
4481,A Family Man,1641235,0,1641235,2017.csv,2017,-,100%
4482,Sorry Angel,1636273,30628,1605645,2018.csv,2018,1.9%,98.1%
4483,Student of the Year 2,1635907,778566,857341,2019.csv,2019,47.6%,52.4%
4484,Since Otar Left,1634307,350391,1283916,2003.csv,2003,21.4%,78.6%
4485,Mohenjo Daro,1630231,1264339,365892,2016.csv,2016,77.6%,22.4%
4486,Iris,1620708,1310678,310030,2015.csv,2015,80.9%,19.1%
4487,All You Need Is Love,1620654,0,1620654,2014.csv,2014,-,100%
4488,I Still See You,1620637,1359,1619278,2018.csv,2018,<0.1%,99.9%
4489,Son of Sardaar,1618361,771789,846572,2012.csv,2012,47.7%,52.3%
4490,Grand Piano,1618085,22555,1595530,2013.csv,2013,1.4%,98.6%
4491,Anjaana Anjaani,1615888,854757,761131,2010.csv,2010,52.9%,47.1%
4492,In My Father's Den,1614675,0,1614675,2004.csv,2004,-,100%
4493,The Corporation,1613533,1613533,0,2004.csv,2004,100%,-
4494,Session 9,1612259,378176,1234083,2001.csv,2001,23.5%,76.5%
4495,Singin' in the Rain 2012 Re-release,1609789,1608925,864,2012.csv,2012,99.9%,<0.1%
4496,Walk With Me,1606705,726726,879979,2017.csv,2017,45.2%,54.8%
4497,More Than Honey,1604609,79772,1524837,2012.csv,2012,5%,95%
4498,We Are the Best!,1604273,180590,1423683,2013.csv,2013,11.3%,88.7%
4499,Northfork,1599804,1420578,179226,2003.csv,2003,88.8%,11.2%
4500,The Code,1598493,13152,1585341,2002.csv,2002,0.8%,99.2%
4501,Yamla Pagla Deewana,1597269,993031,604238,2011.csv,2011,62.2%,37.8%
4502,The Metropolitan Opera HD Live: Verdi: Aida,1595902,1595902,0,2018.csv,2018,100%,-
4503,Made in India,1594164,790628,803536,2018.csv,2018,49.6%,50.4%
4504,Queen of the Desert,1592853,0,1592853,2015.csv,2015,-,100%
4505,It's All Gone Pete Tong,1591879,120620,1471259,2005.csv,2005,7.6%,92.4%
4506,Nine Lives,1591523,478830,1112693,2005.csv,2005,30.1%,69.9%
4507,I Am,1591034,1591034,0,2011.csv,2011,100%,-
4508,The Crossing,1589212,90896,1498316,2019.csv,2019,5.7%,94.3%
4509,Dance Academy: The Movie,1586858,0,1586858,2017.csv,2017,-,100%
4510,Lovelace,1585583,356582,1229001,2013.csv,2013,22.5%,77.5%
4511,Two 2004 Re-release,1585139,47806,1537333,2004.csv,2004,3%,97%
4512,Make Your Move,1583687,125106,1458581,2012.csv,2012,7.9%,92.1%
4513,The Bay,1581252,30668,1550584,2012.csv,2012,1.9%,98.1%
4514,Lou! Journal infime,1581125,287,1580838,2014.csv,2014,<0.1%,100%
4515,The Stray,1579440,1579440,0,2017.csv,2017,100%,-
4516,Lay the Favorite,1576687,20998,1555689,2012.csv,2012,1.3%,98.7%
4517,After Midnight,1576003,50469,1525534,2004.csv,2004,3.2%,96.8%
4518,Adore,1575749,318982,1256767,2013.csv,2013,20.2%,79.8%
4519,Genesis: Paradise Lost,1575000,1575000,0,2017.csv,2017,100%,-
4520,Teri Meri Kahaani,1574703,781196,793507,2012.csv,2012,49.6%,50.4%
4521,Human Nature,1574660,705308,869352,2002.csv,2002,44.8%,55.2%
4522,9 Songs,1574623,66853,1507770,2004.csv,2004,4.2%,95.8%
4523,Teen Spirit,1573601,441366,1132235,2019.csv,2019,28%,72%
4524,Cesare deve morire,1567339,76908,1490431,2012.csv,2012,4.9%,95.1%
4525,Hope Springs,1567189,0,1567189,2003.csv,2003,-,100%
4526,Ushpizin,1565016,1400666,164350,2005.csv,2005,89.5%,10.5%
4527,"Bless Me, Ultima",1561962,1561962,0,2013.csv,2013,100%,-
4528,Batman Begins 2012 Re-release,1559514,1508658,50856,2012.csv,2012,96.7%,3.3%
4529,Persecuted,1558836,1558836,0,2014.csv,2014,100%,-
4530,Parineeta,1558018,802758,755260,2005.csv,2005,51.5%,48.5%
4531,The Kid,1553483,1508593,44890,2019.csv,2019,97.1%,2.9%
4532,Out of Control,1553195,36486,1516709,2003.csv,2003,2.3%,97.7%
4533,Eros,1553020,188392,1364628,2004.csv,2004,12.1%,87.9%
4534,Still Mine,1552730,1159336,393394,2013.csv,2013,74.7%,25.3%
4535,Yardie,1551163,36012,1515151,2018.csv,2018,2.3%,97.7%
4536,A Home at the End of the World,1548955,1029872,519083,2004.csv,2004,66.5%,33.5%
4537,Tel Aviv on Fire,1548893,506145,1042748,2019.csv,2019,32.7%,67.3%
4538,Cold in July,1547630,427418,1120212,2014.csv,2014,27.6%,72.4%
4539,Lagaan: Once Upon a Time in India,1546734,835767,710967,2001.csv,2001,54%,46%
4540,Fed Up,1546229,1538899,7330,2014.csv,2014,99.5%,0.5%
4541,"New York, New York",1545352,92377,1452975,2016.csv,2016,6%,94%
4542,The Lords of Salem,1544989,1165882,379107,2013.csv,2013,75.5%,24.5%
4543,Mystery Train,1544973,1541218,3755,2018.csv,2018,99.8%,0.2%
4544,Divided We Fall 2001 Re-release,1544317,1332586,211731,2001.csv,2001,86.3%,13.7%
4545,Rampart,1543613,972512,571101,2012.csv,2012,63%,37%
4546,The Wedding Plan,1542345,1412404,129941,2016.csv,2016,91.6%,8.4%
4547,The Chaperone,1541223,600654,940569,2019.csv,2019,39%,61%
4548,Kedarnath,1538846,901131,637715,2018.csv,2018,58.6%,41.4%
4549,Monos,1534584,406473,1128111,2019.csv,2019,26.5%,73.5%
4550,Reaching for the Moon,1534391,45502,1488889,2013.csv,2013,3%,97%
4551,Love,1533874,309200,1224674,2012.csv,2012,20.2%,79.8%
4552,The Blind Swordsman: Zatoichi 2004 Re-release,1532969,862894,670075,2004.csv,2004,56.3%,43.7%
4553,The Bullet Vanishes,1528580,117629,1410951,2012.csv,2012,7.7%,92.3%
4554,Gold,1528185,5539,1522646,2017.csv,2017,0.4%,99.6%
4555,Certain Women,1526698,1087585,439113,2016.csv,2016,71.2%,28.8%
4556,Mysterious Skin,1524966,713240,811726,2005.csv,2005,46.8%,53.2%
4557,The Sea Is Watching,1523691,30577,1493114,2002.csv,2002,2%,98%
4558,Dogtown and Z-Boys,1523090,1300682,222408,2002.csv,2002,85.4%,14.6%
4559,The Syrian Bride,1522967,380505,1142462,2005.csv,2005,25%,75%
4560,She Hate Me,1522377,366037,1156340,2004.csv,2004,24%,76%
4561,Shaadi Ke Side Effects,1521778,921277,600501,2014.csv,2014,60.5%,39.5%
4562,The Kid Stays in the Picture,1521593,1439232,82361,2002.csv,2002,94.6%,5.4%
4563,Princess Mononoke 2018 Re-release,1519321,1423877,95444,2018.csv,2018,93.7%,6.3%
4564,The Dark Knight 2012 Re-release,1513086,1513086,0,2012.csv,2012,100%,-
4565,My Golden Days,1509773,269144,1240629,2015.csv,2015,17.8%,82.2%
4566,Dum Maaro Dum,1508912,564489,944423,2011.csv,2011,37.4%,62.6%
4567,The Daughter,1505434,26376,1479058,2016.csv,2016,1.8%,98.2%
4568,The Kings of Summer,1501595,1315590,186005,2013.csv,2013,87.6%,12.4%
4569,Priceless,1499605,1499605,0,2016.csv,2016,100%,-
4570,The Blind Swordsman: Zatoichi Canadian Release,1496523,255269,1241254,2004.csv,2004,17.1%,82.9%
4571,Moka,1493067,129547,1363520,2016.csv,2016,8.7%,91.3%
4572,The Artist and the Model,1492780,127958,1364822,2012.csv,2012,8.6%,91.4%
4573,In My Country,1491434,163893,1327541,2004.csv,2004,11%,89%
4574,Mully,1489771,1489771,0,2017.csv,2017,100%,-
4575,Patti Cake$,1482356,800148,682208,2017.csv,2017,54%,46%
4576,Oasis: Supersonic,1478119,242867,1235252,2016.csv,2016,16.4%,83.6%
4577,Freeheld,1474471,573335,901136,2015.csv,2015,38.9%,61.1%
4578,Good Kill,1474471,316472,1157999,2015.csv,2015,21.5%,78.5%
4579,Mausam,1473341,728316,745025,2011.csv,2011,49.4%,50.6%
4580,De De Pyaar De,1473116,425934,1047182,2019.csv,2019,28.9%,71.1%
4581,A Pigeon Sat on a Branch Reflecting on Existence,1472431,222989,1249442,2014.csv,2014,15.1%,84.9%
4582,Jimmy P.,1470582,30283,1440299,2013.csv,2013,2.1%,97.9%
4583,Violeta Went to Heaven,1466032,21496,1444536,2011.csv,2011,1.5%,98.5%
4584,Modigliani,1466013,205165,1260848,2004.csv,2004,14%,86%
4585,Thelma,1463727,147391,1316336,2017.csv,2017,10.1%,89.9%
4586,Joshua,1461635,1461635,0,2002.csv,2002,100%,-
4587,The Center of the World,1460687,1101344,359343,2001.csv,2001,75.4%,24.6%
4588,Life of Crime,1456675,265452,1191223,2014.csv,2014,18.2%,81.8%
4589,The Miseducation of Cameron Post,1451729,904703,547026,2018.csv,2018,62.3%,37.7%
4590,The Other Woman,1451343,25423,1425920,2010.csv,2010,1.8%,98.2%
4591,The Disappearance of Eleanor Rigby: Them,1448076,587774,860302,2014.csv,2014,40.6%,59.4%
4592,The City of Your Final Destination,1444401,493296,951105,2010.csv,2010,34.2%,65.8%
4593,Besharam,1443479,679866,763613,2013.csv,2013,47.1%,52.9%
4594,The Dawn Wall 2018 Re-release,1442013,970032,471981,2018.csv,2018,67.3%,32.7%
4595,No Good Deed,1440653,181600,1259053,2002.csv,2002,12.6%,87.4%
4596,My Friend Dahmer,1436751,1361611,75140,2017.csv,2017,94.8%,5.2%
4597,Restrepo,1436391,1330894,105497,2010.csv,2010,92.7%,7.3%
4598,Kai po che!,1435272,1122527,312745,2013.csv,2013,78.2%,21.8%
4599,Monica la mitraille,1435015,1435015,0,2004.csv,2004,100%,-
4600,Timecode,1431406,1057750,373656,2000.csv,2000,73.9%,26.1%
4601,The Devil's Hand,1428494,5746,1422748,2014.csv,2014,0.4%,99.6%
4602,The Zero Theorem,1428362,257706,1170656,2014.csv,2014,18%,82%
4603,Mere Brother Ki Dulhan,1427275,496172,931103,2011.csv,2011,34.8%,65.2%
4604,Fairy Tail: Dragon Cry,1420035,519461,900574,2017.csv,2017,36.6%,63.4%
4605,Black Butterflies,1416573,0,1416573,2011.csv,2011,-,100%
4606,It 2019 Re-release,1414696,1347126,67570,2019.csv,2019,95.2%,4.8%
4607,The Wolfpack,1414140,1301696,112444,2015.csv,2015,92%,8%
4608,Bombón: El Perro,1412753,19791,1392962,2005.csv,2005,1.4%,98.6%
4609,Parkland,1412181,653651,758530,2013.csv,2013,46.3%,53.7%
4610,Saint Ralph,1410952,489389,921563,2005.csv,2005,34.7%,65.3%
4611,Lost in La Mancha,1407019,732393,674626,2002.csv,2002,52.1%,47.9%
4612,Lazer Team,1406538,1186426,220112,2016.csv,2016,84.4%,15.6%
4613,Just a Sigh,1406331,75531,1330800,2013.csv,2013,5.4%,94.6%
4614,El Chicano,1404646,1400603,4043,2019.csv,2019,99.7%,0.3%
4615,Haider,1404307,1048143,356164,2014.csv,2014,74.6%,25.4%
4616,Universal Soldier: Day of Reckoning,1402307,5460,1396847,2012.csv,2012,0.4%,99.6%
4617,Born to Be Blue 2016 Re-release,1401411,678203,723208,2016.csv,2016,48.4%,51.6%
4618,Vox Lux,1399272,727119,672153,2018.csv,2018,52%,48%
4619,Criminal,1398053,929233,468820,2004.csv,2004,66.5%,33.5%
4620,Maggie,1394052,187112,1206940,2015.csv,2015,13.4%,86.6%
4621,White Material,1392434,304020,1088414,2010.csv,2010,21.8%,78.2%
4622,Holiday,1390054,706893,683161,2014.csv,2014,50.9%,49.1%
4623,"Oslo, August 31st",1386378,101475,1284903,2011.csv,2011,7.3%,92.7%
4624,"For a Good Time, Call...",1386088,1251749,134339,2012.csv,2012,90.3%,9.7%
4625,House of Tolerance,1384443,19327,1365116,2011.csv,2011,1.4%,98.6%
4626,Silver City,1384395,1020656,363739,2004.csv,2004,73.7%,26.3%
4627,Sometimes Always Never,1377856,0,1377856,2018.csv,2018,-,100%
4628,Swimming with Men,1377748,24708,1353040,2018.csv,2018,1.8%,98.2%
4629,Ma ma,1375709,47258,1328451,2015.csv,2015,3.4%,96.6%
4630,Khoobsurat,1375623,710508,665115,2014.csv,2014,51.6%,48.4%
4631,For Sama,1374201,43796,1330405,2019.csv,2019,3.2%,96.8%
4632,A Good Old Fashioned Orgy,1369485,200227,1169258,2011.csv,2011,14.6%,85.4%
4633,The Salvation,1363964,44903,1319061,2014.csv,2014,3.3%,96.7%
4634,Little Italy,1362536,990230,372306,2018.csv,2018,72.7%,27.3%
4635,Gimme Shelter,1362018,1359910,2108,2014.csv,2014,99.8%,0.2%
4636,Agent Vinod,1361471,698210,663261,2012.csv,2012,51.3%,48.7%
4637,The Bank,1360012,88414,1271598,2001.csv,2001,6.5%,93.5%
4638,Chasing Ice,1358668,1328467,30201,2012.csv,2012,97.8%,2.2%
4639,Raavan,1356461,708726,647735,2010.csv,2010,52.2%,47.8%
4640,Alien 2019 Re-release,1356259,833658,522601,2019.csv,2019,61.5%,38.5%
4641,Foxtrot,1356159,618883,737276,2018.csv,2018,45.6%,54.4%
4642,Papa,1356033,26677,1329356,2016.csv,2016,2%,98%
4643,Le dernier tunnel,1352489,1352489,0,2004.csv,2004,100%,-
4644,The Oscar Nominated Short Films 2011: Live Action,1352152,1352152,0,2011.csv,2011,100%,-
4645,Unforgivable,1351146,154189,1196957,2011.csv,2011,11.4%,88.6%
4646,The Teacher,1350426,64437,1285989,2016.csv,2016,4.8%,95.2%
4647,The Snowtown Murders,1349387,8452,1340935,2011.csv,2011,0.6%,99.4%
4648,The Cokeville Miracle,1348456,1348456,0,2015.csv,2015,100%,-
4649,The Gathering,1346475,0,1346475,2003.csv,2003,-,100%
4650,Ashoka the Great,1340718,731277,609441,2001.csv,2001,54.5%,45.5%
4651,The Rider Named Death,1338136,3375,1334761,2004.csv,2004,0.3%,99.7%
4652,Student of the Year,1337281,670086,667195,2012.csv,2012,50.1%,49.9%
4653,Barney Thomson,1336254,0,1336254,2015.csv,2015,-,100%
4654,Godard Mon Amour,1335846,82264,1253582,2017.csv,2017,6.2%,93.8%
4655,Darna Mana Hai,1335493,132348,1203145,2003.csv,2003,9.9%,90.1%
4656,Mandy,1335484,1214525,120959,2018.csv,2018,90.9%,9.1%
4657,Sarah Silverman: Jesus Is Magic,1333799,1324339,9460,2005.csv,2005,99.3%,0.7%
4658,The Metropolitan Opera HD Live: Rossini: Semiramide,1332900,1033651,299249,2018.csv,2018,77.5%,22.5%
4659,Ghost in the Shell: The New Movie,1332311,101203,1231108,2015.csv,2015,7.6%,92.4%
4660,Kapow,1331922,812737,519185,2016.csv,2016,61%,39%
4661,Ajami,1331651,622403,709248,2010.csv,2010,46.7%,53.3%
4662,Ballets Russes,1331363,815848,515515,2005.csv,2005,61.3%,38.7%
4663,Baar Baar Dekho,1329777,981947,347830,2016.csv,2016,73.8%,26.2%
4664,The Ultimate Life,1327841,1327841,0,2013.csv,2013,100%,-
4665,It's a Wonderful Afterlife,1321438,0,1321438,2010.csv,2010,-,100%
4666,Catfish in Black Bean Sauce,1319592,1319592,0,2000.csv,2000,100%,-
4667,Off the Map,1319492,1317167,2325,2005.csv,2005,99.8%,0.2%
4668,Storytelling,1318945,921445,397500,2001.csv,2001,69.9%,30.1%
4669,The Look of Love,1318468,21252,1297216,2013.csv,2013,1.6%,98.4%
4670,Noi the Albino,1317132,60555,1256577,2003.csv,2003,4.6%,95.4%
4671,Erased,1314735,0,1314735,2012.csv,2012,-,100%
4672,Damsels in Distress,1314358,1008455,305903,2012.csv,2012,76.7%,23.3%
4673,Saints and Soldiers,1310470,1310470,0,2004.csv,2004,100%,-
4674,Air Racers 3D,1309987,1309987,0,2012.csv,2012,100%,-
4675,Come What May,1309818,37766,1272052,2015.csv,2015,2.9%,97.1%
4676,Dom Hemingway,1307599,523511,784088,2013.csv,2013,40%,60%
4677,Heights,1306281,1160817,145464,2005.csv,2005,88.9%,11.1%
4678,Something in the Air,1305473,85154,1220319,2012.csv,2012,6.5%,93.5%
4679,The Metropolitan Opera HD Live: Mozart: Così fan tutte,1302949,1302949,0,2018.csv,2018,100%,-
4680,Les Cowboys,1302493,73725,1228768,2015.csv,2015,5.7%,94.3%
4681,Sunset Song,1302482,159714,1142768,2015.csv,2015,12.3%,87.7%
4682,Jesus' Son,1302067,1302067,0,2000.csv,2000,100%,-
4683,Hard to Be a God,1299035,28608,1270427,2014.csv,2014,2.2%,97.8%
4684,Yamakasi,1297401,184441,1112960,2001.csv,2001,14.2%,85.8%
4685,Slow West,1295574,229094,1066480,2015.csv,2015,17.7%,82.3%
4686,Roger Waters - Us + Them,1294480,611644,682836,2019.csv,2019,47.3%,52.7%
4687,Under Suspicion,1291020,260562,1030458,2000.csv,2000,20.2%,79.8%
4688,The Business of Strangers,1287598,1030920,256678,2001.csv,2001,80.1%,19.9%
4689,The Cakemaker,1287568,875751,411817,2018.csv,2018,68%,32%
4690,Time Changer,1285167,1285167,0,2002.csv,2002,100%,-
4691,Festival Express,1281754,1174079,107675,2004.csv,2004,91.6%,8.4%
4692,I Spit on Your Grave,1278650,93051,1185599,2010.csv,2010,7.3%,92.7%
4693,Howl,1278390,617334,661056,2010.csv,2010,48.3%,51.7%
4694,Black Souls,1278360,101088,1177272,2014.csv,2014,7.9%,92.1%
4695,Ek Villain,1278108,730530,547578,2014.csv,2014,57.2%,42.8%
4696,Shed Skin Papa,1278065,13331,1264734,2018.csv,2018,1%,99%
4697,Kontroll,1277800,237183,1040617,2003.csv,2003,18.6%,81.4%
4698,City of Ghosts,1277187,357197,919990,2003.csv,2003,28%,72%
4699,The Believer,1274112,416925,857187,2001.csv,2001,32.7%,67.3%
4700,Yellow Submarine,1273261,992305,280956,2018.csv,2018,77.9%,22.1%
4701,The Women's Balcony,1272517,1200885,71632,2017.csv,2017,94.4%,5.6%
4702,Beautifully Broken,1271572,1209645,61927,2018.csv,2018,95.1%,4.9%
4703,Tai Chi Zero,1271521,212094,1059427,2012.csv,2012,16.7%,83.3%
4704,Texas Killing Fields,1271319,45469,1225850,2011.csv,2011,3.6%,96.4%
4705,September 11,1266063,127035,1139028,2002.csv,2002,10%,90%
4706,Fagara,1265949,43417,1222532,2019.csv,2019,3.4%,96.6%
4707,Why Don't You Play in Hell?,1265872,28534,1237338,2013.csv,2013,2.3%,97.7%
4708,Batla House,1264337,493180,771157,2019.csv,2019,39%,61%
4709,Valley of Love,1264277,28648,1235629,2015.csv,2015,2.3%,97.7%
4710,Black 2005 Re-release,1263200,754819,508381,2005.csv,2005,59.8%,40.2%
4711,The Holy Girl,1261792,304124,957668,2004.csv,2004,24.1%,75.9%
4712,Chonda Pierce: Enough,1260116,1260116,0,2017.csv,2017,100%,-
4713,Meerkats,1259616,777595,482021,2012.csv,2012,61.7%,38.3%
4714,The Music of Strangers: Yo-Yo Ma and the Silk Road Ensemble,1259588,1176781,82807,2016.csv,2016,93.4%,6.6%
4715,Gett,1259160,988150,271010,2014.csv,2014,78.5%,21.5%
4716,Bewafaa,1258036,670076,587960,2005.csv,2005,53.3%,46.7%
4717,Guy,1257937,1319,1256618,2018.csv,2018,0.1%,99.9%
4718,Anna,1257142,4288,1252854,2014.csv,2014,0.3%,99.7%
4719,For a Woman,1252416,32286,1220130,2013.csv,2013,2.6%,97.4%
4720,Demi-soeur,1251642,943,1250699,2013.csv,2013,<0.1%,99.9%
4721,The Singles Ward,1250798,1250798,0,2002.csv,2002,100%,-
4722,MVP: Most Valuable Primate,1248746,1248746,0,2000.csv,2000,100%,-
4723,Turn It Up,1247949,1247949,0,2000.csv,2000,100%,-
4724,The Ledge,1247188,9216,1237972,2011.csv,2011,0.7%,99.3%
4725,Midnight's Children,1243980,190022,1053958,2012.csv,2012,15.3%,84.7%
4726,Slumber,1243832,0,1243832,2017.csv,2017,-,100%
4727,1945,1240663,1006193,234470,2017.csv,2017,81.1%,18.9%
4728,Seducing Doctor Lewis 2004 Re-release,1239278,489838,749440,2004.csv,2004,39.5%,60.5%
4729,Bubba Ho-Tep,1239183,1239183,0,2003.csv,2003,100%,-
4730,Nuit de noces,1238180,1238180,0,2001.csv,2001,100%,-
4731,Saving Face,1236518,1187266,49252,2005.csv,2005,96%,4%
4732,Beyond the Mask,1236094,1236094,0,2015.csv,2015,100%,-
4733,The Blue Room,1232900,254666,978234,2014.csv,2014,20.7%,79.3%
4734,The Cut,1232140,28066,1204074,2014.csv,2014,2.3%,97.7%
4735,Life,1231606,0,1231606,2015.csv,2015,-,100%
4736,True to the Game,1231040,1231040,0,2017.csv,2017,100%,-
4737,Steve McQueen: American Icon,1229782,1229782,0,2017.csv,2017,100%,-
4738,Casablanca 2011 Re-release,1226808,1155330,71478,2011.csv,2011,94.2%,5.8%
4739,Rory O'Shea Was Here,1226577,23844,1202733,2004.csv,2004,1.9%,98.1%
4740,BTS World Tour 'Love Yourself: Speak Yourself' (The Final) Seoul Live Viewing,1226552,1226552,0,2019.csv,2019,100%,-
4741,That Sugar Film,1226399,3500,1222899,2015.csv,2015,0.3%,99.7%
4742,Satyagraha,1223419,738525,484894,2013.csv,2013,60.4%,39.6%
4743,Santa vs. the Snowman 3D 2005 Re-release,1222538,1222538,0,2005.csv,2005,100%,-
4744,Tomboy,1221392,129834,1091558,2011.csv,2011,10.6%,89.4%
4745,Sister,1218174,154659,1063515,2012.csv,2012,12.7%,87.3%
4746,Alexandra's Project,1217812,752148,465664,2003.csv,2003,61.8%,38.2%
4747,Ilo Ilo,1216181,56773,1159408,2013.csv,2013,4.7%,95.3%
4748,When We Leave,1214076,19631,1194445,2010.csv,2010,1.6%,98.4%
4749,Woman Thou Art Loosed: On the 7th Day,1213128,1213128,0,2012.csv,2012,100%,-
4750,Clandestine Childhood,1212354,9017,1203337,2012.csv,2012,0.7%,99.3%
4751,Uncle Boonmee Who Can Recall His Past Lives,1212206,184292,1027914,2010.csv,2010,15.2%,84.8%
4752,Margaret Cho: I'm the One That I Want,1210967,1210967,0,2000.csv,2000,100%,-
4753,Kochadaiiyaan,1210580,817192,393388,2014.csv,2014,67.5%,32.5%
4754,Casino Jack,1209709,1042959,166750,2010.csv,2010,86.2%,13.8%
4755,The Way He Looks,1207841,101451,1106390,2014.csv,2014,8.4%,91.6%
4756,Noble 2014 Re-release,1207386,347321,860065,2014.csv,2014,28.8%,71.2%
4757,Alone in Berlin,1205598,33125,1172473,2016.csv,2016,2.7%,97.3%
4758,Inequality for All,1205273,1205273,0,2013.csv,2013,100%,-
4759,Meek's Cutoff,1205257,977772,227485,2011.csv,2011,81.1%,18.9%
4760,In the Land of Blood and Honey,1203699,303877,899822,2011.csv,2011,25.2%,74.8%
4761,"Beats, Rhymes & Life: The Travels of A Tribe Called Quest",1200326,1200326,0,2011.csv,2011,100%,-
4762,The Affair of the Necklace,1198113,471210,726903,2001.csv,2001,39.3%,60.7%
4763,Phantom,1197759,1034589,163170,2013.csv,2013,86.4%,13.6%
4764,No Entry,1197530,678000,519530,2005.csv,2005,56.6%,43.4%
4765,Spirited Away 2017 Re-release,1196791,1196791,0,2017.csv,2017,100%,-
4766,The Captain,1196669,109226,1087443,2018.csv,2018,9.1%,90.9%
4767,Yi Yi,1196218,1136776,59442,2000.csv,2000,95%,5%
4768,The Metropolitan Opera HD Live: Saint-Saëns: Samson et Dalila,1195758,1195758,0,2018.csv,2018,100%,-
4769,Repentance,1194961,1189612,5349,2014.csv,2014,99.6%,0.4%
4770,The First Grader,1194710,332000,862710,2011.csv,2011,27.8%,72.2%
4771,When You're Strange,1194182,246078,948104,2010.csv,2010,20.6%,79.4%
4772,Free Men,1192651,53810,1138841,2011.csv,2011,4.5%,95.5%
4773,Backstage,1191835,1191835,0,2000.csv,2000,100%,-
4774,Indigo,1190000,1190000,0,2005.csv,2005,100%,-
4775,Time Out,1189692,448542,741150,2001.csv,2001,37.7%,62.3%
4776,Kingdom Men Rising,1188936,1188936,0,2019.csv,2019,100%,-
4777,Shubh Mangal Savdhan,1188541,689874,498667,2017.csv,2017,58%,42%
4778,Kill the Irishman,1188194,1188194,0,2011.csv,2011,100%,-
4779,Dead Snow 2,1187477,37473,1150004,2014.csv,2014,3.2%,96.8%
4780,Los Domirriqueños 2,1187280,1187280,0,2019.csv,2019,100%,-
4781,Chuck & Buck,1182065,1055671,126394,2000.csv,2000,89.3%,10.7%
4782,Remember 2016 Re-release,1181023,637555,543468,2016.csv,2016,54%,46%
4783,Fire at Sea,1178377,120933,1057444,2016.csv,2016,10.3%,89.7%
4784,Any Body Can Dance 2,1176958,892133,284825,2015.csv,2015,75.8%,24.2%
4785,Owning Mahowny,1176302,1011871,164431,2003.csv,2003,86%,14%
4786,National Theater Live: Cyrano de Bergerac,1173512,86300,1087212,2019.csv,2019,7.4%,92.6%
4787,Little Manhattan,1172444,385373,787071,2005.csv,2005,32.9%,67.1%
4788,Double Dhamaal,1172240,543646,628594,2011.csv,2011,46.4%,53.6%
4789,Raanjhanaa,1171761,903232,268529,2013.csv,2013,77.1%,22.9%
4790,The Innkeepers,1169750,78396,1091354,2012.csv,2012,6.7%,93.3%
4791,Dark Tide,1167612,0,1167612,2012.csv,2012,-,100%
4792,The Metropolitan Opera HD Live: Verdi: Luisa Miller,1166858,1166858,0,2018.csv,2018,100%,-
4793,Ki & Ka,1166781,857986,308795,2016.csv,2016,73.5%,26.5%
4794,You Ain't Seen Nothin' Yet,1166740,18929,1147811,2012.csv,2012,1.6%,98.4%
4795,The Emperor's New Clothes,1165545,661903,503642,2001.csv,2001,56.8%,43.2%
4796,The Best Two Years,1163450,1163450,0,2004.csv,2004,100%,-
4797,Vaxxed: From Cover-Up to Catastrophe,1163265,1163265,0,2016.csv,2016,100%,-
4798,Groove,1162001,1115313,46688,2000.csv,2000,96%,4%
4799,Trois,1161843,1161843,0,2000.csv,2000,100%,-
4800,Louder Than Bombs,1160724,163807,996917,2015.csv,2015,14.1%,85.9%
4801,Where Hope Grows,1159072,1156000,3072,2015.csv,2015,99.7%,0.3%
4802,Breathe,1158695,42297,1116398,2014.csv,2014,3.7%,96.3%
4803,Darling Companion,1157257,793815,363442,2012.csv,2012,68.6%,31.4%
4804,Napping Princess,1156847,48198,1108649,2017.csv,2017,4.2%,95.8%
4805,Embrace: The Documentary,1155263,629126,526137,2016.csv,2016,54.5%,45.5%
4806,Jagga Jasoos,1154862,861740,293122,2017.csv,2017,74.6%,25.4%
4807,Step,1152839,1146292,6547,2017.csv,2017,99.4%,0.6%
4808,The Reckoning,1152528,257252,895276,2004.csv,2004,22.3%,77.7%
4809,Liberal Arts,1150681,327345,823336,2012.csv,2012,28.4%,71.6%
4810,Les aimants,1150414,1150414,0,2004.csv,2004,100%,-
4811,Cartel Land,1145923,704352,441571,2015.csv,2015,61.5%,38.5%
4812,Elliot the Littlest Reindeer 2018 Re-release,1142187,24262,1117925,2018.csv,2018,2.1%,97.9%
4813,Honeyland,1140879,815082,325797,2019.csv,2019,71.4%,28.6%
4814,Roma,1140769,0,1140769,2018.csv,2018,-,100%
4815,The Song of Names,1138700,1077584,61116,2019.csv,2019,94.6%,5.4%
4816,The Hollars,1138609,1016985,121624,2016.csv,2016,89.3%,10.7%
4817,Fathom Premieres 6 Below: Miracle on the Mountain,1135531,14838,1120693,2017.csv,2017,1.3%,98.7%
4818,Cell,1133031,0,1133031,2016.csv,2016,-,100%
4819,Miral,1132843,373420,759423,2010.csv,2010,33%,67%
4820,Dancer,1131649,71917,1059732,2016.csv,2016,6.4%,93.6%
4821,Stranger by the Lake,1131241,325196,806045,2013.csv,2013,28.7%,71.3%
4822,Weekend,1128477,484592,643885,2011.csv,2011,42.9%,57.1%
4823,The Lady and the Duke,1128137,331051,797086,2001.csv,2001,29.3%,70.7%
4824,In the Name of,1127938,9883,1118055,2013.csv,2013,0.9%,99.1%
4825,Tosca,1125058,69613,1055445,2001.csv,2001,6.2%,93.8%
4826,Man-Thing,1123136,0,1123136,2005.csv,2005,-,100%
4827,Paper Clips,1121744,1121744,0,2004.csv,2004,100%,-
4828,Look Away,1119537,0,1119537,2018.csv,2018,-,100%
4829,Papa Hemingway in Cuba,1117399,1115615,1784,2016.csv,2016,99.8%,0.2%
4830,The Mill and the Cross,1116180,312187,803993,2011.csv,2011,28%,72%
4831,The Metropolitan Opera HD Live: Donizetti: L'Elisir d'Amore,1115018,1115018,0,2018.csv,2018,100%,-
4832,A War,1114663,122902,991761,2015.csv,2015,11%,89%
4833,The Selfish Giant,1114027,12189,1101838,2013.csv,2013,1.1%,98.9%
4834,Walking with the Enemy,1112592,1112592,0,2014.csv,2014,100%,-
4835,Jet Lag 2003 Re-release,1112018,544964,567054,2003.csv,2003,49%,51%
4836,The R.M.,1111615,1111615,0,2003.csv,2003,100%,-
4837,Sordid Lives,1111273,1111273,0,2001.csv,2001,100%,-
4838,The Overnight,1110522,1110522,0,2015.csv,2015,100%,-
4839,Sacred Planet,1108356,1108356,0,2004.csv,2004,100%,-
4840,Intimate Stories,1108009,102897,1005112,2002.csv,2002,9.3%,90.7%
4841,My Neighbor Totoro 2019 Re-release,1105564,1105564,0,2019.csv,2019,100%,-
4842,"Peace, Love & Misunderstanding",1105020,590700,514320,2012.csv,2012,53.5%,46.5%
4843,American Desi,1104408,907835,196573,2001.csv,2001,82.2%,17.8%
4844,The Heart Specialist,1103037,1103037,0,2011.csv,2011,100%,-
4845,The Insanity of God,1102525,1102525,0,2016.csv,2016,100%,-
4846,El Coyote,1101470,1101470,0,2019.csv,2019,100%,-
4847,Chaar Sahibzaade 2: Rise of Banda Singh Bahadur 2016 Re-release,1100947,700723,400224,2016.csv,2016,63.6%,36.4%
4848,Beyond the Reach,1100432,45895,1054537,2015.csv,2015,4.2%,95.8%
4849,Yaadein...,1093819,1000229,93590,2001.csv,2001,91.4%,8.6%
4850,Columbus,1093077,1017107,75970,2017.csv,2017,93%,7%
4851,Northern Soul,1092359,8886,1083473,2014.csv,2014,0.8%,99.2%
4852,Bombshell: The Hedy Lamarr Story,1092277,820300,271977,2017.csv,2017,75.1%,24.9%
4853,The Son of No One,1091132,30680,1060452,2011.csv,2011,2.8%,97.2%
4854,Snowboarder,1090565,27732,1062833,2003.csv,2003,2.5%,97.5%
4855,The Man Who Cried,1090432,747092,343340,2001.csv,2001,68.5%,31.5%
4856,The Goonies 2019 Re-release,1089463,864378,225085,2019.csv,2019,79.3%,20.7%
4857,The Sky Is Pink,1088641,652592,436049,2019.csv,2019,59.9%,40.1%
4858,Tycoon: A New Russian,1086121,123159,962962,2002.csv,2002,11.3%,88.7%
4859,Sunset,1083299,164906,918393,2018.csv,2018,15.2%,84.8%
4860,Undiscovered,1082784,1069318,13466,2005.csv,2005,98.8%,1.2%
4861,Jesus Is King,1082629,973000,109629,2019.csv,2019,89.9%,10.1%
4862,Mystify: Michael Hutchence,1082456,289573,792883,2019.csv,2019,26.8%,73.2%
4863,The Statement,1079822,765637,314185,2003.csv,2003,70.9%,29.1%
4864,The Cup,1079108,1079108,0,2000.csv,2000,100%,-
4865,Page One: Inside the New York Times,1077982,1067028,10954,2011.csv,2011,99%,1%
4866,Turtles Can Fly,1075553,258578,816975,2005.csv,2005,24%,76%
4867,The Salton Sea,1073198,764554,308644,2002.csv,2002,71.2%,28.8%
4868,The First Monday in May,1072943,527474,545469,2016.csv,2016,49.2%,50.8%
4869,Killing Season,1071322,39881,1031441,2013.csv,2013,3.7%,96.3%
4870,When Brendan Met Trudy,1069648,133376,936272,2001.csv,2001,12.5%,87.5%
4871,Au nom de ma fille,1066493,1623,1064870,2016.csv,2016,0.2%,99.8%
4872,The Oogieloves in the Big Balloon Adventure,1065907,1065907,0,2012.csv,2012,100%,-
4873,50 to 1,1064454,1064454,0,2014.csv,2014,100%,-
4874,La Mission,1062941,1062941,0,2010.csv,2010,100%,-
4875,Carlos,1059369,145526,913843,2010.csv,2010,13.7%,86.3%
4876,Bennett's War,1056416,1056416,0,2019.csv,2019,100%,-
4877,Borgman,1052010,57474,994536,2013.csv,2013,5.5%,94.5%
4878,All Over the Guy,1051948,1022324,29624,2001.csv,2001,97.2%,2.8%
4879,No One Lives,1048704,74918,973786,2013.csv,2013,7.1%,92.9%
4880,Aarakshan,1048507,651096,397411,2011.csv,2011,62.1%,37.9%
4881,Extremedays,1047553,1047553,0,2001.csv,2001,100%,-
4882,A Tale of Two Sisters,1045252,72541,972711,2003.csv,2003,6.9%,93.1%
4883,A Brilliant Young Mind,1043620,171793,871827,2015.csv,2015,16.5%,83.5%
4884,Hecho en México,1042673,151133,891540,2012.csv,2012,14.5%,85.5%
4885,Khatta Meetha,1040814,541904,498910,2010.csv,2010,52.1%,47.9%
4886,Spark: A Space Tail,1040689,196458,844231,2017.csv,2017,18.9%,81.1%
4887,Befikre,1040421,498000,542421,2016.csv,2016,47.9%,52.1%
4888,The Dark Crystal 2018 Re-release,1036956,1036956,0,2018.csv,2018,100%,-
4889,Swept Away,1036520,598645,437875,2002.csv,2002,57.8%,42.2%
4890,Noah: The Musical,1035603,1035603,0,2019.csv,2019,100%,-
4891,Unconditional,1034448,1005800,28648,2012.csv,2012,97.2%,2.8%
4892,Margaret Cho: Notorious C.H.O.,1033395,1033395,0,2002.csv,2002,100%,-
4893,Urbania,1032075,1032075,0,2000.csv,2000,100%,-
4894,Ain't Them Bodies Saints,1031243,396519,634724,2013.csv,2013,38.5%,61.5%
4895,We Are Family,1031070,638144,392926,2010.csv,2010,61.9%,38.1%
4896,The Eyes of Tammy Faye,1029591,1029591,0,2000.csv,2000,100%,-
4897,Breaking News,1028420,0,1028420,2004.csv,2004,-,100%
4898,Knight of Cups,1026288,566006,460282,2015.csv,2015,55.2%,44.8%
4899,Casablanca 2017 Re-release,1024560,1024560,0,2017.csv,2017,100%,-
4900,Tangerines,1024132,144501,879631,2015.csv,2015,14.1%,85.9%
4901,The Metropolitan Opera HD Live: Puccini: La Fanciulla del West,1023233,1023233,0,2018.csv,2018,100%,-
4902,"The Bread, My Sweet",1023156,1023156,0,2001.csv,2001,100%,-
4903,Pinjar,1022336,66290,956046,2003.csv,2003,6.5%,93.5%
4904,Ma Mère,1022148,71616,950532,2004.csv,2004,7%,93%
4905,The Taste of Others,1021938,891369,130569,2000.csv,2000,87.2%,12.8%
4906,Leaves of Grass,1018753,70066,948687,2010.csv,2010,6.9%,93.1%
4907,The Oscar Nominated Short Films 2010: Live Action,1018169,1018169,0,2010.csv,2010,100%,-
4908,On a Clear Day,1017257,191033,826224,2005.csv,2005,18.8%,81.2%
4909,Husband Material,1016545,567417,449128,2018.csv,2018,55.8%,44.2%
4910,Savage Messiah,1015671,1015671,0,2002.csv,2002,100%,-
4911,Two Family House,1015122,1015122,0,2000.csv,2000,100%,-
4912,Assassination Tango,1013272,1013272,0,2003.csv,2003,100%,-
4913,Big Stone Gap,1012804,1009301,3503,2015.csv,2015,99.7%,0.3%
4914,L'attesa,1010766,55804,954962,2015.csv,2015,5.5%,94.5%
4915,Elvis: The Comeback Special,1010657,1010657,0,2018.csv,2018,100%,-
4916,Far from Men,1010485,5336,1005149,2015.csv,2015,0.5%,99.5%
4917,Cold Blood,1009888,5083,1004805,2019.csv,2019,0.5%,99.5%
4918,The Song,1009620,1009620,0,2014.csv,2014,100%,-
4919,Francofonia,1008154,307040,701114,2015.csv,2015,30.5%,69.5%
4920,Sidewalls,1008116,2377,1005739,2011.csv,2011,0.2%,99.8%
4921,Lilya 4-Ever,1007747,184023,823724,2002.csv,2002,18.3%,81.7%
4922,The Princess and the Warrior,1004858,872091,132767,2001.csv,2001,86.8%,13.2%
4923,Ghost House,1004155,0,1004155,2017.csv,2017,-,100%
4924,Faith of Our Fathers,1004105,1004105,0,2015.csv,2015,100%,-
4925,Kiki's Delivery Service 2019 Re-release,1004057,1004057,0,2019.csv,2019,100%,-
4926,Valentin 2003 Re-release,1002172,275968,726204,2003.csv,2003,27.5%,72.5%
4927,The Workshop,1000056,22061,977995,2017.csv,2017,2.2%,97.8%
4928,Gabbar is Back,998582,534601,463981,2015.csv,2015,53.5%,46.5%
4929,National Theatre Live: Antony & Cleopatra,998079,83672,914407,2018.csv,2018,8.4%,91.6%
4930,The Son,997544,70262,927282,2002.csv,2002,7%,93%
4931,"Polina, danser sa vie",996425,165203,831222,2016.csv,2016,16.6%,83.4%
4932,Photograph,996171,344534,651637,2019.csv,2019,34.6%,65.4%
4933,Burn,996103,996103,0,2012.csv,2012,100%,-
4934,Long Live Freedom 2014 Re-release,995990,48541,947449,2014.csv,2014,4.9%,95.1%
4935,Duma,994790,870067,124723,2005.csv,2005,87.5%,12.5%
4936,Child's Pose,994126,97170,896956,2013.csv,2013,9.8%,90.2%
4937,Labyrinth 2018 Re-release,993336,993336,0,2018.csv,2018,100%,-
4938,Blue Ruin,993313,258384,734929,2014.csv,2014,26%,74%
4939,All Access: Front Row. Backstage. Live!,992683,992683,0,2001.csv,2001,100%,-
4940,Beyond Skyline,992181,0,992181,2017.csv,2017,-,100%
4941,First Descent,988368,750805,237563,2005.csv,2005,76%,24%
4942,Blackthorn,987883,200558,787325,2011.csv,2011,20.3%,79.7%
4943,The Greatest,985181,114766,870415,2010.csv,2010,11.6%,88.4%
4944,Miles Davis: Birth of the Cool,984499,614201,370298,2019.csv,2019,62.4%,37.6%
4945,Being Flynn,983124,540152,442972,2012.csv,2012,54.9%,45.1%
4946,Transit,982372,815290,167082,2018.csv,2018,83%,17%
4947,Schindler's List 2018 Re-release,981489,833050,148439,2018.csv,2018,84.9%,15.1%
4948,Mr. Pip,977855,1714,976141,2013.csv,2013,0.2%,99.8%
4949,Stuck in Love.,977671,81071,896600,2013.csv,2013,8.3%,91.7%
4950,Saraband,975181,645634,329547,2004.csv,2004,66.2%,33.8%
4951,Who Killed Bambi?,973173,14532,958641,2003.csv,2003,1.5%,98.5%
4952,Journey's End,970809,161796,809013,2018.csv,2018,16.7%,83.3%
4953,An American Rhapsody,970676,850255,120421,2001.csv,2001,87.6%,12.4%
4954,Trishna,967672,240381,727291,2012.csv,2012,24.8%,75.2%
4955,Ryuichi Sakamoto: Coda,960212,117460,842752,2018.csv,2018,12.2%,87.8%
4956,Rush: Cinema Strangiato 2019,960073,960073,0,2019.csv,2019,100%,-
4957,A Prayer Before Dawn,958883,14453,944430,2018.csv,2018,1.5%,98.5%
4958,The Endless,956425,272020,684405,2018.csv,2018,28.4%,71.6%
4959,The Fighting Preacher,954641,954641,0,2019.csv,2019,100%,-
4960,The Catcher Was a Spy,953953,725223,228730,2018.csv,2018,76%,24%
4961,The Farewell Party,951531,172860,778671,2015.csv,2015,18.2%,81.8%
4962,Gimme Danger,950040,440627,509413,2016.csv,2016,46.4%,53.6%
4963,Under the Tree,944991,67596,877395,2017.csv,2017,7.2%,92.8%
4964,The Dinner,944808,7282,937526,2014.csv,2014,0.8%,99.2%
4965,Rebel in the Rye,944370,378294,566076,2017.csv,2017,40.1%,59.9%
4966,Dark Horse 2016 Re-release,944061,940715,3346,2016.csv,2016,99.6%,0.4%
4967,Afterimage,943029,33443,909586,2017.csv,2017,3.5%,96.5%
4968,The Road,942041,92476,849565,2011.csv,2011,9.8%,90.2%
4969,Landline,940854,940854,0,2017.csv,2017,100%,-
4970,Becoming Astrid,938766,120486,818280,2018.csv,2018,12.8%,87.2%
4971,Kaili Blues,935236,32164,903072,2016.csv,2016,3.4%,96.6%
4972,Barely Lethal,933847,6075,927772,2015.csv,2015,0.7%,99.3%
4973,Perfect Sense,933352,2959,930393,2011.csv,2011,0.3%,99.7%
4974,Dancing Arabs,930958,281540,649418,2015.csv,2015,30.2%,69.8%
4975,Simpatico,929606,929606,0,2000.csv,2000,100%,-
4976,White Christmas 2018 Re-release,928298,928298,0,2018.csv,2018,100%,-
4977,Like Arrows,928265,817990,110275,2018.csv,2018,88.1%,11.9%
4978,Toni Morrison: The Pieces I Am,927495,903018,24477,2019.csv,2019,97.4%,2.6%
4979,Aimee & Jaguar,927107,927107,0,2000.csv,2000,100%,-
4980,How I Live Now,925762,60213,865549,2013.csv,2013,6.5%,93.5%
4981,Patterns of Evidence: Exodus,925576,925576,0,2015.csv,2015,100%,-
4982,Khakee,924170,587877,336293,2004.csv,2004,63.6%,36.4%
4983,The Yards,924036,889352,34684,2000.csv,2000,96.2%,3.8%
4984,Gentleman,923884,897876,26008,2016.csv,2016,97.2%,2.8%
4985,ATM,921752,3010,918742,2012.csv,2012,0.3%,99.7%
4986,Paradise,921242,14873,906369,2017.csv,2017,1.6%,98.4%
4987,Palo Alto,919591,767732,151859,2014.csv,2014,83.5%,16.5%
4988,Back to 1942,918487,312954,605533,2012.csv,2012,34.1%,65.9%
4989,Kirk Cameron: Connect,918127,918127,0,2018.csv,2018,100%,-
4990,Faithless,918033,739055,178978,2001.csv,2001,80.5%,19.5%
4991,Hasee Toh Phasee,916906,646035,270871,2014.csv,2014,70.5%,29.5%
4992,The Lodgers,916727,7362,909365,2018.csv,2018,0.8%,99.2%
4993,The Ballad of Jack and Rose,916051,712275,203776,2005.csv,2005,77.8%,22.2%
4994,Revenge,913331,102091,811240,2018.csv,2018,11.2%,88.8%
4995,Kings,910269,274635,635634,2018.csv,2018,30.2%,69.8%
4996,Seymour: An Introduction,907742,743541,164201,2015.csv,2015,81.9%,18.1%
4997,Sholem Aleichem: Laughing in the Darkness,906666,906666,0,2011.csv,2011,100%,-
4998,The Dead Lands,906158,5240,900918,2014.csv,2014,0.6%,99.4%
4999,Bitter Harvest,904399,557241,347158,2017.csv,2017,61.6%,38.4%
5000,Generation Iron,901649,849521,52128,2013.csv,2013,94.2%,5.8%
5001,A Song for Martin,900626,27983,872643,2001.csv,2001,3.1%,96.9%
5002,The Hummingbird Project,899037,371784,527253,2019.csv,2019,41.4%,58.6%
5003,The Wildest Dream,898137,898137,0,2010.csv,2010,100%,-
5004,The Game Changers,897992,739711,158281,2019.csv,2019,82.4%,17.6%
5005,The Disappearance of Alice Creed,896919,166980,729939,2010.csv,2010,18.6%,81.4%
5006,A Woman's Life,895944,37626,858318,2016.csv,2016,4.2%,95.8%
5007,Place Vendôme,895788,895788,0,2000.csv,2000,100%,-
5008,You're Not You,894964,11486,883478,2014.csv,2014,1.3%,98.7%
5009,Memories of Murder,894521,15357,879164,2003.csv,2003,1.7%,98.3%
5010,Best of Enemies: Buckley vs. Vidal,892802,892802,0,2015.csv,2015,100%,-
5011,Lucky: No Time for Love,891789,453507,438282,2005.csv,2005,50.9%,49.1%
5012,Personal Velocity,890502,811299,79203,2002.csv,2002,91.1%,8.9%
5013,Believe,890303,890303,0,2016.csv,2016,100%,-
5014,Alone Yet Not Alone,887851,887851,0,2013.csv,2013,100%,-
5015,The Future,887172,568662,318510,2011.csv,2011,64.1%,35.9%
5016,La otra conquista,886410,886410,0,2000.csv,2000,100%,-
5017,Code 46,886018,285585,600433,2004.csv,2004,32.2%,67.8%
5018,The Claim,885836,669258,216578,2000.csv,2000,75.6%,24.4%
5019,Gaz Bar Blues,884664,884664,0,2003.csv,2003,100%,-
5020,Princess Kaiulani,883887,883887,0,2010.csv,2010,100%,-
5021,Pandora's Box,881950,881950,0,2002.csv,2002,100%,-
5022,Venom,881779,881779,0,2005.csv,2005,100%,-
5023,Ai Weiwei: Never Sorry,881661,534100,347561,2012.csv,2012,60.6%,39.4%
5024,Between Me and My Mind,875191,875191,0,2019.csv,2019,100%,-
5025,The Polar Express 2017 IMAX Release,875150,875150,0,2017.csv,2017,100%,-
5026,Lajja,871706,376000,495706,2001.csv,2001,43.1%,56.9%
5027,Particle Fever,869838,869838,0,2014.csv,2014,100%,-
5028,Mirrormask,866999,866999,0,2005.csv,2005,100%,-
5029,The Other Side of the Bed 2003 Re-release,866250,113543,752707,2003.csv,2003,13.1%,86.9%
5030,Bird People,866211,32111,834100,2014.csv,2014,3.7%,96.3%
5031,Howl's Moving Castle 2019 Re-release,865647,865647,0,2019.csv,2019,100%,-
5032,The Metropolitan Opera HD Live: Nico Muhly: Marnie,865551,849710,15841,2018.csv,2018,98.2%,1.8%
5033,The Battle of Algiers 2004 Re-release,865058,822941,42117,2004.csv,2004,95.1%,4.9%
5034,Latter Days,865028,834685,30343,2004.csv,2004,96.5%,3.5%
5035,Veer,861630,527193,334437,2010.csv,2010,61.2%,38.8%
5036,Love,861057,249083,611974,2015.csv,2015,28.9%,71.1%
5037,Highway,858783,529136,329647,2014.csv,2014,61.6%,38.4%
5038,Night Moves,858513,271755,586758,2014.csv,2014,31.7%,68.3%
5039,Himalaya,857100,132007,725093,2000.csv,2000,15.4%,84.6%
5040,The Nightingale,855756,400209,455547,2019.csv,2019,46.8%,53.2%
5041,Steel Magnolias 2019 Re-release,855421,855421,0,2019.csv,2019,100%,-
5042,Chain Letter,855185,138788,716397,2010.csv,2010,16.2%,83.8%
5043,A Touch of Sin,854891,154120,700771,2013.csv,2013,18%,82%
5044,Happythankyoumoreplease,853862,216110,637752,2011.csv,2011,25.3%,74.7%
5045,I'm Going Home,853526,140872,712654,2002.csv,2002,16.5%,83.5%
5046,Brigham City,852206,852206,0,2001.csv,2001,100%,-
5047,The Sea of Trees,850985,20444,830541,2016.csv,2016,2.4%,97.6%
5048,31,850419,779820,70599,2016.csv,2016,91.7%,8.3%
5049,Wilson,848646,653951,194695,2017.csv,2017,77.1%,22.9%
5050,Atlas Shrugged: Who Is John Galt?,846704,846704,0,2014.csv,2014,100%,-
5051,Monty Python's Life of Brian 2004 Re-release,846635,646951,199684,2004.csv,2004,76.4%,23.6%
5052,The Polar Express 2015 IMAX Release,846602,846602,0,2015.csv,2015,100%,-
5053,Lizzie,844786,642157,202629,2018.csv,2018,76%,24%
5054,Heartbeats,843423,68723,774700,2010.csv,2010,8.1%,91.9%
5055,Higher Ground 2011 Re-release,843370,841733,1637,2011.csv,2011,99.8%,0.2%
5056,Gunday,843232,0,843232,2014.csv,2014,-,100%
5057,Mary Kom,839840,621300,218540,2014.csv,2014,74%,26%
5058,BANDSTAND: The Broadway Musical on Screen,839554,839554,0,2018.csv,2018,100%,-
5059,Hôtel Normandy,836709,4640,832069,2013.csv,2013,0.6%,99.4%
5060,Khiladi 786,835095,379466,455629,2012.csv,2012,45.4%,54.6%
5061,The Exception,834572,708973,125599,2017.csv,2017,85%,15%
5062,Premam,834525,828278,6247,2016.csv,2016,99.3%,0.7%
5063,The Whistlers,833602,55608,777994,2019.csv,2019,6.7%,93.3%
5064,Chillar Party,832150,6330,825820,2011.csv,2011,0.8%,99.2%
5065,Blow Dry,830286,637769,192517,2001.csv,2001,76.8%,23.2%
5066,Gold Diggers,829140,527000,302140,2004.csv,2004,63.6%,36.4%
5067,Byzantium,828284,89237,739047,2013.csv,2013,10.8%,89.2%
5068,Detective Byomkesh Bakshy!,827437,579055,248382,2015.csv,2015,70%,30%
5069,Mary,827179,0,827179,2005.csv,2005,-,100%
5070,13 Sins,826913,13809,813104,2014.csv,2014,1.7%,98.3%
5071,The Shape of Things,826617,735992,90625,2003.csv,2003,89%,11%
5072,K: Missing Kings,826323,33531,792792,2014.csv,2014,4.1%,95.9%
5073,The Saddest Music in the World,824777,699225,125552,2004.csv,2004,84.8%,15.2%
5074,Inside,824414,0,824414,2017.csv,2017,-,100%
5075,The Thing About My Folks,823337,816403,6934,2005.csv,2005,99.2%,0.8%
5076,The Lord of the Rings: The Return of the King 2011 Re-release,818580,818580,0,2011.csv,2011,100%,-
5077,Break Ke Baad,816988,427628,389360,2010.csv,2010,52.3%,47.7%
5078,Life Itself,815645,810454,5191,2014.csv,2014,99.4%,0.6%
5079,Vita & Virginia,815419,42741,772678,2019.csv,2019,5.2%,94.8%
5080,Saw 10th Anniversary Release,815324,815324,0,2014.csv,2014,100%,-
5081,What If...,814906,814906,0,2010.csv,2010,100%,-
5082,Tangerine,814868,702354,112514,2015.csv,2015,86.2%,13.8%
5083,Charly,814666,814666,0,2002.csv,2002,100%,-
5084,Age of Uprising: The Legend of Michael Kohlhaas,813550,3313,810237,2013.csv,2013,0.4%,99.6%
5085,The Heiresses,811196,78473,732723,2018.csv,2018,9.7%,90.3%
5086,Bangistan,810419,48694,761725,2015.csv,2015,6%,94%
5087,So Close,810243,76584,733659,2002.csv,2002,9.5%,90.5%
5088,Bill W.,809590,809590,0,2012.csv,2012,100%,-
5089,Joni 75: A Birthday Celebration,808831,752205,56626,2019.csv,2019,93%,7%
5090,Breathing,807436,4630,802806,2011.csv,2011,0.6%,99.4%
5091,Behind the Sun,805755,19861,785894,2001.csv,2001,2.5%,97.5%
5092,V/H/S/2,805574,21833,783741,2013.csv,2013,2.7%,97.3%
5093,About Adam,802951,159668,643283,2001.csv,2001,19.9%,80.1%
5094,Mean Creek,802948,603951,198997,2004.csv,2004,75.2%,24.8%
5095,The Tillman Story,802535,802535,0,2010.csv,2010,100%,-
5096,The Wrecking Crew!,801606,801606,0,2015.csv,2015,100%,-
5097,My Mother Likes Women 2004 Re-release,801048,82916,718132,2004.csv,2004,10.4%,89.6%
5098,Chunhyang,798977,798977,0,2000.csv,2000,100%,-
5099,Red Army,798680,694600,104080,2015.csv,2015,87%,13%
5100,Wakefield,798214,262599,535615,2017.csv,2017,32.9%,67.1%
5101,Twin Sisters 2004 Re-release,794365,1563,792802,2004.csv,2004,0.2%,99.8%
5102,Tickled,790519,613956,176563,2016.csv,2016,77.7%,22.3%
5103,Thin Ice,790421,790421,0,2012.csv,2012,100%,-
5104,Lootera,789671,581813,207858,2013.csv,2013,73.7%,26.3%
5105,Momentum,789406,0,789406,2015.csv,2015,-,100%
5106,Trembling Before G-d,788896,788896,0,2001.csv,2001,100%,-
5107,Chonda Pierce: Unashamed,787979,787979,0,2019.csv,2019,100%,-
5108,George Takei's Allegiance,784850,784850,0,2017.csv,2017,100%,-
5109,Life During Wartime,783232,281447,501785,2010.csv,2010,35.9%,64.1%
5110,Party Monster,782606,742898,39708,2003.csv,2003,94.9%,5.1%
5111,The Paris Opera,781039,55482,725557,2017.csv,2017,7.1%,92.9%
5112,Futuro Beach,779835,20262,759573,2014.csv,2014,2.6%,97.4%
5113,Panic,779137,779137,0,2000.csv,2000,100%,-
5114,Foolproof,779036,458990,320046,2003.csv,2003,58.9%,41.1%
5115,Mrs. Hyde,778142,18627,759515,2018.csv,2018,2.4%,97.6%
5116,Enter the Void,775385,336467,438918,2010.csv,2010,43.4%,56.6%
5117,The D Train,774780,673151,101629,2015.csv,2015,86.9%,13.1%
5118,New Waterford Girl,774469,774469,0,2000.csv,2000,100%,-
5119,Morvern Callar,772336,267907,504429,2002.csv,2002,34.7%,65.3%
5120,The Church,772000,772000,0,2019.csv,2019,100%,-
5121,The Girl Next Door,771792,771792,0,2000.csv,2000,100%,-
5122,Grand Masti,770535,413903,356632,2013.csv,2013,53.7%,46.3%
5123,Pariah,769552,769552,0,2011.csv,2011,100%,-
5124,Passion of Mind,769272,769272,0,2000.csv,2000,100%,-
5125,The Lord of the Rings: The Fellowship of the Ring 2011 Re-release,768580,768580,0,2011.csv,2011,100%,-
5126,Theeb,768449,283024,485425,2015.csv,2015,36.8%,63.2%
5127,Yalom's Cure,766974,1164,765810,2014.csv,2014,0.2%,99.8%
5128,Lo and Behold: Reveries of the Connected World,765796,594912,170884,2016.csv,2016,77.7%,22.3%
5129,Fat Girl,765705,725854,39851,2001.csv,2001,94.8%,5.2%
5130,DanTDM Presents The Contest,765363,307484,457879,2019.csv,2019,40.2%,59.8%
5131,Patterns of Evidence: Moses Controversy,765361,765361,0,2019.csv,2019,100%,-
5132,The Polar Express 2016 IMAX Release,765154,765154,0,2016.csv,2016,100%,-
5133,The Lord of the Rings: The Two Towers 2011 Re-release,764607,764607,0,2011.csv,2011,100%,-
5134,The Prophet,764498,355343,409155,2015.csv,2015,46.5%,53.5%
5135,The Invisibles,764250,407373,356877,2018.csv,2018,53.3%,46.7%
5136,Texas Rangers,763740,623374,140366,2001.csv,2001,81.6%,18.4%
5137,Pick of the Litter,763688,578717,184971,2018.csv,2018,75.8%,24.2%
5138,Broken Wings,760318,421454,338864,2003.csv,2003,55.4%,44.6%
5139,The Shining 2017 Re-release,760309,421572,338737,2017.csv,2017,55.4%,44.6%
5140,Museo,759626,148505,611121,2018.csv,2018,19.5%,80.5%
5141,Bombay Velvet,758478,450692,307786,2015.csv,2015,59.4%,40.6%
5142,Uzak,757008,96293,660715,2003.csv,2003,12.7%,87.3%
5143,Boundaries,755977,703438,52539,2018.csv,2018,93.1%,6.9%
5144,I Love Lucy: A Colorized Celebration,754323,754323,0,2019.csv,2019,100%,-
5145,Middle Men,754301,754301,0,2010.csv,2010,100%,-
5146,The Passenger 2005 Re-release,751607,620155,131452,2005.csv,2005,82.5%,17.5%
5147,Tommy's Honour,751345,569306,182039,2017.csv,2017,75.8%,24.2%
5148,Little Secrets,750582,405792,344790,2002.csv,2002,54.1%,45.9%
5149,A Five Star Life 2014 Re-release,749653,306917,442736,2014.csv,2014,40.9%,59.1%
5150,Cronicas,749607,300322,449285,2005.csv,2005,40.1%,59.9%
5151,Hobo with a Shotgun,748453,703372,45081,2011.csv,2011,94%,6%
5152,Arthur Newman,747140,207853,539287,2013.csv,2013,27.8%,72.2%
5153,The Bride of Humpty Sharma,746788,380011,366777,2014.csv,2014,50.9%,49.1%
5154,Holy Rollers,744266,303064,441202,2010.csv,2010,40.7%,59.3%
5155,C.S.A.: The Confederate States of America,744165,672156,72009,2005.csv,2005,90.3%,9.7%
5156,Saturday's Warrior,744046,744046,0,2016.csv,2016,100%,-
5157,Fade to Black,742076,728921,13155,2004.csv,2004,98.2%,1.8%
5158,Scarface 2003 Re-release,739905,739905,0,2003.csv,2003,100%,-
5159,"Kumiko, the Treasure Hunter",739623,623383,116240,2015.csv,2015,84.3%,15.7%
5160,Forks Over Knives,739561,739561,0,2011.csv,2011,100%,-
5161,Vicky Donor,739085,549001,190084,2012.csv,2012,74.3%,25.7%
5162,Kadosh,736812,736812,0,2000.csv,2000,100%,-
5163,Wiener-Dog,734729,477453,257276,2016.csv,2016,65%,35%
5164,Ramen Shop,734347,88455,645892,2018.csv,2018,12%,88%
5165,David Crosby: Remember My Name,732793,732793,0,2019.csv,2019,100%,-
5166,Once I Was a Beehive,732655,732655,0,2015.csv,2015,100%,-
5167,Tabloid,731925,696921,35004,2011.csv,2011,95.2%,4.8%
5168,The Polar Express 2018 Re-release,731018,731018,0,2018.csv,2018,100%,-
5169,Slaughterhouse Rulez,730762,4665,726097,2018.csv,2018,0.6%,99.4%
5170,How I Ended This Summer,730412,8733,721679,2010.csv,2010,1.2%,98.8%
5171,Land Ho!,727594,727594,0,2014.csv,2014,100%,-
5172,Peggy Guggenheim: Art Addict,727591,498428,229163,2015.csv,2015,68.5%,31.5%
5173,Liz and the Blue Bird,726454,63204,663250,2018.csv,2018,8.7%,91.3%
5174,Bullett Raja,725588,0,725588,2013.csv,2013,-,100%
5175,May it Last: A Portrait of the Avett Brothers,725286,725286,0,2017.csv,2017,100%,-
5176,Aquarela,725269,307346,417923,2019.csv,2019,42.4%,57.6%
5177,A Tale of Love and Darkness,724885,572212,152673,2015.csv,2015,78.9%,21.1%
5178,Levity,723040,209695,513345,2003.csv,2003,29%,71%
5179,The Act of Killing,722714,486919,235795,2013.csv,2013,67.4%,32.6%
5180,Where's My Roy Cohn?,722603,705274,17329,2019.csv,2019,97.6%,2.4%
5181,Singham,722451,350864,371587,2011.csv,2011,48.6%,51.4%
5182,12 Days,722049,5204,716845,2017.csv,2017,0.7%,99.3%
5183,Effie Gray,721143,352534,368609,2014.csv,2014,48.9%,51.1%
5184,Revive Us 2,718607,718607,0,2017.csv,2017,100%,-
5185,Garage Days,716888,32500,684388,2002.csv,2002,4.5%,95.5%
5186,The Shining 2012 Re-release,715736,342749,372987,2012.csv,2012,47.9%,52.1%
5187,Passion,713616,92181,621435,2013.csv,2013,12.9%,87.1%
5188,Gerhard Richter Painting,713188,242646,470542,2011.csv,2011,34%,66%
5189,Shanghai Ghetto,712446,712446,0,2002.csv,2002,100%,-
5190,Shootout at Wadala,711366,369573,341793,2013.csv,2013,52%,48%
5191,The Polar Express 2011 IMAX Release,711168,711168,0,2011.csv,2011,100%,-
5192,Extraction,710636,16775,693861,2015.csv,2015,2.4%,97.6%
5193,Inside Deep Throat,709832,691880,17952,2005.csv,2005,97.5%,2.5%
5194,Kaal,709777,345091,364686,2005.csv,2005,48.6%,51.4%
5195,Muscle Shoals,709415,696241,13174,2013.csv,2013,98.1%,1.9%
5196,Paris Countdown,708757,1055,707702,2013.csv,2013,0.1%,99.9%
5197,Gori Tere Pyaar Mein!,708440,342184,366256,2013.csv,2013,48.3%,51.7%
5198,HBO Boxing: Canelo Alvarez vs. Gennady Golovkin II,707875,707875,0,2018.csv,2018,100%,-
5199,Passione,707460,255355,452105,2010.csv,2010,36.1%,63.9%
5200,Palindromes,707269,553368,153901,2005.csv,2005,78.2%,21.8%
5201,Bread and Roses,706876,533479,173397,2001.csv,2001,75.5%,24.5%
5202,The Lost Medallion: The Adventures of Billy Stone,705854,549632,156222,2013.csv,2013,77.9%,22.1%
5203,Itzhak,704968,607290,97678,2018.csv,2018,86.1%,13.9%
5204,Blaze,704955,704955,0,2018.csv,2018,100%,-
5205,Bully,704808,480811,223997,2001.csv,2001,68.2%,31.8%
5206,Crossing the Bridge: The Sound of Istanbul,704094,70685,633409,2005.csv,2005,10%,90%
5207,Countdown to Canelo vs. Golovkin,703396,703396,0,2017.csv,2017,100%,-
5208,Buena Vista Social Club: Adios,701575,123445,578130,2017.csv,2017,17.6%,82.4%
5209,Le Quattro Volte,701334,152530,548804,2010.csv,2010,21.7%,78.3%
5210,56 Up,701278,701278,0,2013.csv,2013,100%,-
5211,Our Children,700215,23203,677012,2012.csv,2012,3.3%,96.7%
5212,The Greatest Movie Ever Sold,698249,638476,59773,2011.csv,2011,91.4%,8.6%
5213,Kyun! Ho Gaya Na...,696718,336909,359809,2004.csv,2004,48.4%,51.6%
5214,Himmatwala,696334,270880,425454,2013.csv,2013,38.9%,61.1%
5215,Frankie & Alice 2014 Re-release,695876,695876,0,2014.csv,2014,100%,-
5216,Deewane Huye Paagal,695849,364357,331492,2005.csv,2005,52.4%,47.6%
5217,Frankie,695680,171781,523899,2019.csv,2019,24.7%,75.3%
5218,The Least of These: The Graham Staines Story,695164,607015,88149,2019.csv,2019,87.3%,12.7%
5219,The Congress 2013 Re-release,695131,137815,557316,2013.csv,2013,19.8%,80.2%
5220,Jim Henson's Holiday Special with Fraggle Rock and Emmet Otter,695130,695130,0,2018.csv,2018,100%,-
5221,The Secret Scripture,694981,0,694981,2017.csv,2017,-,100%
5222,In the Aisles,694586,28394,666192,2018.csv,2018,4.1%,95.9%
5223,Raise Hell: The Life & Times of Molly Ivins,694410,694410,0,2019.csv,2019,100%,-
5224,Chris Brown: Welcome To My Life,693984,693984,0,2017.csv,2017,100%,-
5225,Titanic 2017 Re-release,691642,691642,0,2017.csv,2017,100%,-
5226,Close Your Eyes,691495,41392,650103,2004.csv,2004,6%,94%
5227,Ferrari Ki Sawaari,689861,434107,255754,2012.csv,2012,62.9%,37.1%
5228,"The Prize Winner of Defiance, Ohio",689028,627844,61184,2005.csv,2005,91.1%,8.9%
5229,Romeo Akbar Walter,688719,236299,452420,2019.csv,2019,34.3%,65.7%
5230,Happy Accidents,688523,688523,0,2001.csv,2001,100%,-
5231,Cobain: Montage of Heck,687649,0,687649,2015.csv,2015,-,100%
5232,Vettai,687636,204373,483263,2012.csv,2012,29.7%,70.3%
5233,The Caveman's Valentine,687194,687194,0,2001.csv,2001,100%,-
5234,Mr. Church,685780,685780,0,2016.csv,2016,100%,-
5235,Spun,685608,411119,274489,2003.csv,2003,60%,40%
5236,Bethany Hamilton: Unstoppable,684078,590671,93407,2019.csv,2019,86.3%,13.7%
5237,Stefan Zweig: Farewell to Europe 2017 Re-release,683063,78372,604691,2017.csv,2017,11.5%,88.5%
5238,Masti,683021,308566,374455,2004.csv,2004,45.2%,54.8%
5239,Brigsby Bear,681632,532669,148963,2017.csv,2017,78.1%,21.9%
5240,"Right Now, Wrong Then",680728,24470,656258,2015.csv,2015,3.6%,96.4%
5241,3 Generations,680351,155936,524415,2016.csv,2016,22.9%,77.1%
5242,A Matter of Faith,680113,680113,0,2014.csv,2014,100%,-
5243,I Spit on Your Grave 2,678604,809,677795,2013.csv,2013,0.1%,99.9%
5244,All I See Is You,678150,217644,460506,2017.csv,2017,32.1%,67.9%
5245,Baaghi,676602,438207,238395,2016.csv,2016,64.8%,35.2%
5246,Tyrannosaur,676111,22321,653790,2011.csv,2011,3.3%,96.7%
5247,Manderlay,674918,78378,596540,2005.csv,2005,11.6%,88.4%
5248,5 to 7,674579,162685,511894,2015.csv,2015,24.1%,75.9%
5249,Beyond the Hills,673493,124919,548574,2012.csv,2012,18.5%,81.5%
5250,The Trump Prophecy,671198,671198,0,2018.csv,2018,100%,-
5251,Anna and the Apocalypse,670430,545597,124833,2018.csv,2018,81.4%,18.6%
5252,The Polar Express 2012 IMAX Release,669289,669289,0,2012.csv,2012,100%,-
5253,Bright Days Ahead 2013 Re-release,669085,21770,647315,2013.csv,2013,3.3%,96.7%
5254,Phata Poster Nikhla Hero,669070,410526,258544,2013.csv,2013,61.4%,38.6%
5255,Travelers and Magicians,668639,506793,161846,2004.csv,2004,75.8%,24.2%
5256,Tai Chi 2: The Hero Rises,668484,35067,633417,2012.csv,2012,5.2%,94.8%
5257,Girlfriend Boyfriend,667626,64414,603212,2012.csv,2012,9.6%,90.4%
5258,Alias Betty,667087,208400,458687,2001.csv,2001,31.2%,68.8%
5259,Balzac and the Little Chinese Seamstress 2005 Re-release,666327,666327,0,2005.csv,2005,100%,-
5260,A Bottle in the Gaza Sea,666011,5872,660139,2012.csv,2012,0.9%,99.1%
5261,Mr. Gaga: A True Story of Love and Dance,665617,173994,491623,2016.csv,2016,26.1%,73.9%
5262,Stockholm,665527,292590,372937,2019.csv,2019,44%,56%
5263,The Stanford Prison Experiment,663114,660561,2553,2015.csv,2015,99.6%,0.4%
5264,Yes,661946,396760,265186,2005.csv,2005,59.9%,40.1%
5265,Max,660763,539879,120884,2002.csv,2002,81.7%,18.3%
5266,City of Gold,660445,640979,19466,2016.csv,2016,97.1%,2.9%
5267,Camille Claudel 1915,660355,35296,625059,2013.csv,2013,5.3%,94.7%
5268,Another Happy Day,659937,8464,651473,2011.csv,2011,1.3%,98.7%
5269,The Woman in the Fifth,659769,113800,545969,2011.csv,2011,17.2%,82.8%
5270,Dragon Ball Z: Broly - The Legendary Super Saiyan,658982,658982,0,2018.csv,2018,100%,-
5271,Madame Bovary,658532,44235,614297,2015.csv,2015,6.7%,93.3%
5272,Terri,655802,655802,0,2011.csv,2011,100%,-
5273,Dekalog,655720,655720,0,2000.csv,2000,100%,-
5274,The Patience Stone,654587,148671,505916,2013.csv,2013,22.7%,77.3%
5275,No Problem,654369,285468,368901,2010.csv,2010,43.6%,56.4%
5276,Whisky Galore,653866,20991,632875,2017.csv,2017,3.2%,96.8%
5277,Ponyo 2018 Re-release,653072,653072,0,2018.csv,2018,100%,-
5278,Rascals,652756,273829,378927,2011.csv,2011,41.9%,58.1%
5279,In Secret,652228,444179,208049,2013.csv,2013,68.1%,31.9%
5280,Salinger,650675,583633,67042,2013.csv,2013,89.7%,10.3%
5281,Metropolis 2002 Re-release,650422,650422,0,2002.csv,2002,100%,-
5282,The Extra Man,649626,453377,196249,2010.csv,2010,69.8%,30.2%
5283,The Family Fang,649555,262921,386634,2016.csv,2016,40.5%,59.5%
5284,Jodorowsky's Dune,647280,647280,0,2014.csv,2014,100%,-
5285,American Masters: The Life and Times of Allen Ginsberg 2004 Re-release,646951,646951,0,2004.csv,2004,100%,-
5286,Storage 24,646175,72,646103,2012.csv,2012,<0.1%,100%
5287,Miss Minoes 2004 Re-release,645970,256770,389200,2004.csv,2004,39.7%,60.3%
5288,Focus,645418,645418,0,2001.csv,2001,100%,-
5289,The Public,644740,573503,71237,2019.csv,2019,89%,11%
5290,Dracula 3D,643758,8139,635619,2012.csv,2012,1.3%,98.7%
5291,The Inheritance 2003 Re-release,642318,68215,574103,2003.csv,2003,10.6%,89.4%
5292,Love and Honor,641929,19684,622245,2012.csv,2012,3.1%,96.9%
5293,Seberg,640804,434702,206102,2019.csv,2019,67.8%,32.2%
5294,Dust to Glory,640013,640013,0,2005.csv,2005,100%,-
5295,Museum Hours,639121,561457,77664,2012.csv,2012,87.8%,12.2%
5296,Beautiful Boxer,638317,133920,504397,2003.csv,2003,21%,79%
5297,Jack Goes Boating,637479,541992,95487,2010.csv,2010,85%,15%
5298,Welcome to Me,636819,608852,27967,2015.csv,2015,95.6%,4.4%
5299,The Virginity Hit,636706,636706,0,2010.csv,2010,100%,-
5300,Not Fade Away,636399,610792,25607,2012.csv,2012,96%,4%
5301,Elsa & Fred,635901,285863,350038,2014.csv,2014,45%,55%
5302,Batti Gul Meter Chalu,635869,249539,386330,2018.csv,2018,39.2%,60.8%
5303,Goya in Bordeaux,635361,635361,0,2000.csv,2000,100%,-
5304,The Last Lions,635325,635325,0,2011.csv,2011,100%,-
5305,Kaboom,635162,118919,516243,2010.csv,2010,18.7%,81.3%
5306,A Beautiful Life,634784,66171,568613,2011.csv,2011,10.4%,89.6%
5307,Dinner Rush,634566,634566,0,2001.csv,2001,100%,-
5308,No One Killed Jessica,634297,440525,193772,2011.csv,2011,69.5%,30.5%
5309,The Black Prince,632823,0,632823,2017.csv,2017,-,100%
5310,Grace Jones: Bloodlight and Bami,632394,375208,257186,2017.csv,2017,59.3%,40.7%
5311,Jonah: The Musical,631154,631154,0,2017.csv,2017,100%,-
5312,Shut Up and Play the Hits,629107,510334,118773,2012.csv,2012,81.1%,18.9%
5313,Short Peace,628807,22862,605945,2013.csv,2013,3.6%,96.4%
5314,The Trumpet of the Swan,628387,102202,526185,2001.csv,2001,16.3%,83.7%
5315,Asako I & II,627102,25559,601543,2019.csv,2019,4.1%,95.9%
5316,Korkoro,627088,8242,618846,2010.csv,2010,1.3%,98.7%
5317,I'm Still Here,626396,408983,217413,2010.csv,2010,65.3%,34.7%
5318,"Love, Gilda",626318,626318,0,2018.csv,2018,100%,-
5319,Sleepless Night,624913,3358,621555,2011.csv,2011,0.5%,99.5%
5320,Our Lady of the Assassins,624525,525330,99195,2001.csv,2001,84.1%,15.9%
5321,The Sound of Music 2018 Re-release,624392,616171,8221,2018.csv,2018,98.7%,1.3%
5322,Give Me Liberty,624152,242734,381418,2019.csv,2019,38.9%,61.1%
5323,Winter in Wartime 2010 Re-release,623392,543100,80292,2010.csv,2010,87.1%,12.9%
5324,Nancy Drew and the Hidden Staircase,623088,623088,0,2019.csv,2019,100%,-
5325,Dirty Dancing 2019 Re-release,622968,622968,0,2019.csv,2019,100%,-
5326,Range 15,621738,621738,0,2016.csv,2016,100%,-
5327,The Grey Zone,621592,517872,103720,2001.csv,2001,83.3%,16.7%
5328,LOC: Kargil,621103,621103,0,2003.csv,2003,100%,-
5329,Die Hard 30th Anniversary Release,620525,510241,110284,2018.csv,2018,82.2%,17.8%
5330,Better Than Sex,620388,19521,600867,2000.csv,2000,3.1%,96.9%
5331,"Happy, Happy",620238,45154,575084,2010.csv,2010,7.3%,92.7%
5332,The Transformers,619597,619597,0,2018.csv,2018,100%,-
5333,Nowitzki: The Perfect Shot,619517,41340,578177,2014.csv,2014,6.7%,93.3%
5334,Paradise: Faith,618696,6508,612188,2013.csv,2013,1.1%,98.9%
5335,Paulo Coelho's Best Story,617377,8808,608569,2014.csv,2014,1.4%,98.6%
5336,The Butterfly 2003 Re-release,616355,38438,577917,2003.csv,2003,6.2%,93.8%
5337,The Bronze,615816,615816,0,2016.csv,2016,100%,-
5338,Synonyms,615592,206003,409589,2019.csv,2019,33.5%,66.5%
5339,Lost River,615500,45431,570069,2015.csv,2015,7.4%,92.6%
5340,Omar,614444,356000,258444,2013.csv,2013,57.9%,42.1%
5341,Killerman,614366,291477,322889,2019.csv,2019,47.4%,52.6%
5342,Going Upriver: The Long War of John Kerry,614138,614138,0,2004.csv,2004,100%,-
5343,Walking the Camino: Six Ways to Santiago,612717,612717,0,2013.csv,2013,100%,-
5344,The Returned,612521,0,612521,2013.csv,2013,-,100%
5345,The Filth and the Fury,612192,612192,0,2000.csv,2000,100%,-
5346,In Another Country,611365,25079,586286,2012.csv,2012,4.1%,95.9%
5347,The Muppet Movie 2019 Re-release,610475,610475,0,2019.csv,2019,100%,-
5348,Project Nim,609880,411184,198696,2011.csv,2011,67.4%,32.6%
5349,Friday Night,609542,156918,452624,2002.csv,2002,25.7%,74.3%
5350,Dead Before Dawn 3D,608881,0,608881,2012.csv,2012,-,100%
5351,The Last Suit,608209,73548,534661,2017.csv,2017,12.1%,87.9%
5352,Gunner Palace,607844,607844,0,2005.csv,2005,100%,-
5353,Mr. Right,607595,34694,572901,2016.csv,2016,5.7%,94.3%
5354,Dear Wendy,607229,23106,584123,2005.csv,2005,3.8%,96.2%
5355,The Reports on Sarah and Saleem,607206,117479,489727,2018.csv,2018,19.3%,80.7%
5356,Life in a Day,607169,252788,354381,2011.csv,2011,41.6%,58.4%
5357,The Walking Dead: Wrath/The Walking Dead/Fear the Walking Dead: What's Your Story?/Fear the Walking Dead,605764,605764,0,2018.csv,2018,100%,-
5358,Summer in February,605403,1624,603779,2013.csv,2013,0.3%,99.7%
5359,Blue Collar Comedy Tour: The Movie,604856,604856,0,2003.csv,2003,100%,-
5360,The Golden Glove,604147,6160,597987,2019.csv,2019,1%,99%
5361,The Holy Land,603520,603520,0,2003.csv,2003,100%,-
5362,"DCI 2019: Big, Loud & Live 16",603320,603320,0,2018.csv,2018,100%,-
5363,Undertow,602059,108620,493439,2010.csv,2010,18%,82%
5364,A Talking Picture,601815,20237,581578,2003.csv,2003,3.4%,96.6%
5365,The Little Death,601162,18238,582924,2014.csv,2014,3%,97%
5366,Oh Lucy!,600145,375391,224754,2018.csv,2018,62.6%,37.4%
5367,Jimi: All Is by My Side,599840,340911,258929,2014.csv,2014,56.8%,43.2%
5368,The Fencer 2016 Re-release,599537,95952,503585,2016.csv,2016,16%,84%
5369,The Fluffer,599523,563373,36150,2001.csv,2001,94%,6%
5370,The One I Love,596933,513447,83486,2014.csv,2014,86%,14%
5371,Fiza,596591,596591,0,2000.csv,2000,100%,-
5372,Trust,595802,120016,475786,2011.csv,2011,20.1%,79.9%
5373,Skin Trade,595268,1242,594026,2015.csv,2015,0.2%,99.8%
5374,Blue Like Jazz,595018,595018,0,2012.csv,2012,100%,-
5375,My First Mister,595005,568762,26243,2001.csv,2001,95.6%,4.4%
5376,Ixcanul,594836,295157,299679,2015.csv,2015,49.6%,50.4%
5377,Are You Here,594396,0,594396,2014.csv,2014,-,100%
5378,The Armstrong Lie,594394,383294,211100,2013.csv,2013,64.5%,35.5%
5379,Boss,594283,0,594283,2013.csv,2013,-,100%
5380,The Big Lebowski 2018 Re-release,592832,582585,10247,2018.csv,2018,98.3%,1.7%
5381,Not One Less,592586,592586,0,2000.csv,2000,100%,-
5382,To Kill a Mockingbird 2019 Re-release,592237,592237,0,2019.csv,2019,100%,-
5383,Compliance,592116,319285,272831,2012.csv,2012,53.9%,46.1%
5384,Tarnation,592014,592014,0,2004.csv,2004,100%,-
5385,The Cure: Anniversary 1978-2018 Live in Hyde Park,591904,378405,213499,2019.csv,2019,63.9%,36.1%
5386,The Wonderland,591857,50876,540981,2019.csv,2019,8.6%,91.4%
5387,The Human Resources Manager,590567,64014,526553,2010.csv,2010,10.8%,89.2%
5388,Refugee,590000,590000,0,2000.csv,2000,100%,-
5389,Storm Surfers 3D,589945,117090,472855,2012.csv,2012,19.8%,80.2%
5390,Starry Starry Night,589299,10033,579266,2011.csv,2011,1.7%,98.3%
5391,Neither Wolf Nor Dog,589289,589289,0,2017.csv,2017,100%,-
5392,Phir Bhi Dil Hai Hindustani,588606,588606,0,2000.csv,2000,100%,-
5393,Elvis on Tour,587818,587818,0,2010.csv,2010,100%,-
5394,A Time for Drunken Horses,587654,587654,0,2000.csv,2000,100%,-
5395,Thunderstruck,587211,587211,0,2012.csv,2012,100%,-
5396,Upstream Color,587174,444098,143076,2013.csv,2013,75.6%,24.4%
5397,The Piano Player,585604,585604,0,2003.csv,2003,100%,-
5398,The Black Panthers: Vanguard of the Revolution,584109,516893,67216,2015.csv,2015,88.5%,11.5%
5399,The Opportunists,584054,584054,0,2000.csv,2000,100%,-
5400,Undefeated,583844,562218,21626,2012.csv,2012,96.3%,3.7%
5401,Gleason,583664,583664,0,2016.csv,2016,100%,-
5402,The Flat,583443,471842,111601,2012.csv,2012,80.9%,19.1%
5403,Forgive Me Father,582787,582787,0,2001.csv,2001,100%,-
5404,White God,581904,282358,299546,2014.csv,2014,48.5%,51.5%
5405,Three Times,581875,151922,429953,2005.csv,2005,26.1%,73.9%
5406,Touch of Pink,581055,564535,16520,2004.csv,2004,97.2%,2.8%
5407,Novitiate,580346,580346,0,2017.csv,2017,100%,-
5408,All the Real Girls,579986,549666,30320,2003.csv,2003,94.8%,5.2%
5409,Bedeviled,579942,0,579942,2017.csv,2017,-,100%
5410,Around the Bend,579350,193637,385713,2004.csv,2004,33.4%,66.6%
5411,Harry & Snowman,578820,561460,17360,2016.csv,2016,97%,3%
5412,Tibet: Cry of the Snow Lion,578241,578241,0,2003.csv,2003,100%,-
5413,Bilal: A New Breed of Hero 2018 Re-release,576805,490973,85832,2018.csv,2018,85.1%,14.9%
5414,Blizzard,576320,504600,71720,2003.csv,2003,87.6%,12.4%
5415,The Painted Bird,573850,0,573850,2019.csv,2019,-,100%
5416,Mesrine Part 1: Killer Instinct 2010 Re-release,572790,551697,21093,2010.csv,2010,96.3%,3.7%
5417,The Twilight Samurai 2004 Re-release,572565,559765,12800,2004.csv,2004,97.8%,2.2%
5418,The Room 2017 Re-release,572340,549602,22738,2017.csv,2017,96%,4%
5419,The Falling,569498,0,569498,2015.csv,2015,-,100%
5420,Yuva,567746,331166,236580,2004.csv,2004,58.3%,41.7%
5421,The Passion of the Christ Recut Release,567692,508326,59366,2005.csv,2005,89.5%,10.5%
5422,Goodbye to Language,566423,401889,164534,2014.csv,2014,71%,29%
5423,Margaret,564864,46495,518369,2011.csv,2011,8.2%,91.8%
5424,The Weather Underground,564632,564632,0,2003.csv,2003,100%,-
5425,The Cat Returns 2018 Re-release,563718,563718,0,2018.csv,2018,100%,-
5426,Poolhall Junkies,563711,563711,0,2003.csv,2003,100%,-
5427,Like Someone in Love,562878,239056,323822,2012.csv,2012,42.5%,57.5%
5428,Beetlejuice 2018 Re-release,562613,512947,49666,2018.csv,2018,91.2%,8.8%
5429,The Happiest Day in the Life of Olli Maki,562537,0,562537,2016.csv,2016,-,100%
5430,Kurosawa & Mifune Festival,561692,561692,0,2002.csv,2002,100%,-
5431,Kitchen Stories 2004 Re-release,561380,351235,210145,2004.csv,2004,62.6%,37.4%
5432,Me You Them,560943,323923,237020,2001.csv,2001,57.7%,42.3%
5433,My Fair Lady 2019 Re-release,560711,560711,0,2019.csv,2019,100%,-
5434,Fiddler: A Miracle of Miracles,558816,549386,9430,2019.csv,2019,98.3%,1.7%
5435,The Dance of Reality,558636,293680,264956,2013.csv,2013,52.6%,47.4%
5436,Kusama: Infinity,558052,360931,197121,2018.csv,2018,64.7%,35.3%
5437,Forrest Gump 2014 IMAX Release,557683,557683,0,2014.csv,2014,100%,-
5438,Castle in the Sky 2018 Re-release,557541,523664,33877,2018.csv,2018,93.9%,6.1%
5439,Rojo,557092,94757,462335,2018.csv,2018,17%,83%
5440,Tony Takitani,556268,129783,426485,2005.csv,2005,23.3%,76.7%
5441,Samaritan's Purse presents Facing Darkness,555533,555533,0,2017.csv,2017,100%,-
5442,Circumstance,555511,454121,101390,2011.csv,2011,81.7%,18.3%
5443,Dolores,555309,555309,0,2017.csv,2017,100%,-
5444,Every Thing Will Be Fine,554953,9233,545720,2015.csv,2015,1.7%,98.3%
5445,Endless Poetry,554706,153440,401266,2016.csv,2016,27.7%,72.3%
5446,Viral,551760,0,551760,2016.csv,2016,-,100%
5447,Open Windows,550108,1750,548358,2014.csv,2014,0.3%,99.7%
5448,Dhadak,549628,0,549628,2018.csv,2018,-,100%
5449,23 Blast,549185,549185,0,2014.csv,2014,100%,-
5450,We Are X,548126,45270,502856,2016.csv,2016,8.3%,91.7%
5451,Light of My Life,547161,20056,527105,2019.csv,2019,3.7%,96.3%
5452,Planetarium,546584,3262,543322,2016.csv,2016,0.6%,99.4%
5453,A Girl Walks Home Alone at Night,546352,491910,54442,2014.csv,2014,90%,10%
5454,My Generation,546183,0,546183,2018.csv,2018,-,100%
5455,Rudderless,546149,58293,487856,2014.csv,2014,10.7%,89.3%
5456,Masked and Anonymous,546106,533569,12537,2003.csv,2003,97.7%,2.3%
5457,"DCI 2019: Big, Loud & Live 16",546060,546060,0,2019.csv,2019,100%,-
5458,Cet amour-là,545905,72844,473061,2002.csv,2002,13.3%,86.7%
5459,Primer,545436,424760,120676,2004.csv,2004,77.9%,22.1%
5460,Dog Days,545059,13031,532028,2002.csv,2002,2.4%,97.6%
5461,The Art of the Steal,544890,544890,0,2010.csv,2010,100%,-
5462,He's Out There,544674,0,544674,2018.csv,2018,-,100%
5463,Once Upon a Time in the Midlands,544512,172564,371948,2002.csv,2002,31.7%,68.3%
5464,The Day Shall Come,543993,26972,517021,2019.csv,2019,5%,95%
5465,Love & Sex,543896,543896,0,2000.csv,2000,100%,-
5466,On Any Sunday: The Next Chapter,543044,543044,0,2014.csv,2014,100%,-
5467,The Club,541515,52761,488754,2015.csv,2015,9.7%,90.3%
5468,Saathiya,541367,317564,223803,2002.csv,2002,58.7%,41.3%
5469,Passionada,540833,540833,0,2003.csv,2003,100%,-
5470,Dragon Ball Z: Bardock - The Father of Goku/Dragon Ball Z: Fusion Reborn,540707,540707,0,2018.csv,2018,100%,-
5471,Sur le chemin de l'école 2015 Re-release,540658,7424,533234,2015.csv,2015,1.4%,98.6%
5472,Lawless Heart,539596,330067,209529,2003.csv,2003,61.2%,38.8%
5473,The Last Shot,538526,464275,74251,2004.csv,2004,86.2%,13.8%
5474,Lila Says,537871,121365,416506,2005.csv,2005,22.6%,77.4%
5475,Kids in America,537667,537667,0,2005.csv,2005,100%,-
5476,Grateful Dead Meet-Up 2019,537153,537153,0,2019.csv,2019,100%,-
5477,Pretty Persuasion,537126,305800,231326,2005.csv,2005,56.9%,43.1%
5478,CatVideoFest,536566,470923,65643,2019.csv,2019,87.8%,12.2%
5479,Karwaan,536525,182009,354516,2018.csv,2018,33.9%,66.1%
5480,Intacto 2002 Re-release,535420,307333,228087,2002.csv,2002,57.4%,42.6%
5481,Hungry Hearts,534549,6921,527628,2015.csv,2015,1.3%,98.7%
5482,What They Had,533579,260136,273443,2018.csv,2018,48.8%,51.2%
5483,Creature,533235,508714,24521,2011.csv,2011,95.4%,4.6%
5484,Kill Your Friends,533147,0,533147,2015.csv,2015,-,100%
5485,Kahaani 2,532877,350703,182174,2016.csv,2016,65.8%,34.2%
5486,Standing Ovation,531806,531806,0,2010.csv,2010,100%,-
5487,Metropolis 2010 Re-release,529603,529603,0,2010.csv,2010,100%,-
5488,Margaret Atwood: Live in Cinemas,529285,93690,435595,2019.csv,2019,17.7%,82.3%
5489,Evil,528245,15530,512715,2003.csv,2003,2.9%,97.1%
5490,Willy Wonka & the Chocolate Factory 2016 Re-release,526633,526633,0,2016.csv,2016,100%,-
5491,Dil Ka Rishta,526571,352128,174443,2003.csv,2003,66.9%,33.1%
5492,Only Yesterday 2016 Re-release,525958,453243,72715,2016.csv,2016,86.2%,13.8%
5493,Casa de los babys,525715,478031,47684,2003.csv,2003,90.9%,9.1%
5494,The Audience 2019 Re-release,523432,106529,416903,2019.csv,2019,20.4%,79.6%
5495,The Cremaster Cycle,522029,514622,7407,2003.csv,2003,98.6%,1.4%
5496,The Trials of Henry Kissinger,521266,516726,4540,2002.csv,2002,99.1%,0.9%
5497,Hawayein,521260,409978,111282,2003.csv,2003,78.7%,21.3%
5498,Sound City,521181,422853,98328,2013.csv,2013,81.1%,18.9%
5499,The Spy Behind Home Plate,519525,519525,0,2019.csv,2019,100%,-
5500,Wild Nights with Emily,519487,519487,0,2019.csv,2019,100%,-
5501,The Circle 2001 Re-release,519354,440554,78800,2001.csv,2001,84.8%,15.2%
5502,I'm Your Hero,519274,274579,244695,2014.csv,2014,52.9%,47.1%
5503,Scatter My Ashes at Bergdorf's,518342,518342,0,2013.csv,2013,100%,-
5504,Madison,517262,517262,0,2005.csv,2005,100%,-
5505,Trespass Against Us,517197,5711,511486,2017.csv,2017,1.1%,98.9%
5506,Grave of the Fireflies,516962,516962,0,2018.csv,2018,100%,-
5507,Listen to Me Marlon,516337,425831,90506,2015.csv,2015,82.5%,17.5%
5508,The Sandlot 2018 Re-release,516130,516130,0,2018.csv,2018,100%,-
5509,"Love, Wedding, Marriage",515823,1926,513897,2011.csv,2011,0.4%,99.6%
5510,Preacher's Kid,515065,515065,0,2010.csv,2010,100%,-
5511,A Hard Day's Night 2014 Re-release,515005,515005,0,2014.csv,2014,100%,-
5512,Goodbye First Love,514913,95000,419913,2011.csv,2011,18.4%,81.6%
5513,Big Eden,512451,512451,0,2001.csv,2001,100%,-
5514,Mifune,512434,512434,0,2000.csv,2000,100%,-
5515,Bullitt 2018 Re-release,511350,511350,0,2018.csv,2018,100%,-
5516,Black Butler: Book of the Atlantic,511132,248286,262846,2017.csv,2017,48.6%,51.4%
5517,Monsters and Men,510967,500101,10866,2018.csv,2018,97.9%,2.1%
5518,Unsullied,510957,510957,0,2016.csv,2016,100%,-
5519,Bolshoi Ballet: Carmen Suite/Petrushka,510628,207523,303105,2019.csv,2019,40.6%,59.4%
5520,Bol,509872,188850,321022,2011.csv,2011,37%,63%
5521,Karmina 2,508969,508969,0,2001.csv,2001,100%,-
5522,Saving Private Ryan 2019 Re-release,508694,508694,0,2019.csv,2019,100%,-
5523,Una,508169,22815,485354,2017.csv,2017,4.5%,95.5%
5524,The Inevitable Defeat of Mister & Pete,506303,494608,11695,2013.csv,2013,97.7%,2.3%
5525,Our Last Tango,505885,100086,405799,2015.csv,2015,19.8%,80.2%
5526,Gabriel and the Mountain,505769,18415,487354,2017.csv,2017,3.6%,96.4%
5527,Manna from Heaven,505675,505675,0,2002.csv,2002,100%,-
5528,Have a Nice Day,504003,79393,424610,2018.csv,2018,15.8%,84.2%
5529,Letters From Baghdad,502941,359735,143206,2017.csv,2017,71.5%,28.5%
5530,Chuck,502518,320725,181793,2017.csv,2017,63.8%,36.2%
5531,Amadeus Director's Cut,502511,408749,93762,2002.csv,2002,81.3%,18.7%
5532,Shaadi No. 1,502389,336772,165617,2005.csv,2005,67%,33%
5533,Deli Man,502294,502294,0,2015.csv,2015,100%,-
5534,The Triumph of Love,501442,447267,54175,2002.csv,2002,89.2%,10.8%
5535,Bride Flight 2011 Re-release,501360,501360,0,2011.csv,2011,100%,-
5536,His Secret Life,500930,215449,285481,2001.csv,2001,43%,57%
5537,Alice and Martin,500896,500896,0,2000.csv,2000,100%,-
5538,CQ,499891,414358,85533,2002.csv,2002,82.9%,17.1%
5539,Smashed,499725,376597,123128,2012.csv,2012,75.4%,24.6%
5540,Time of the Wolf,499149,61439,437710,2003.csv,2003,12.3%,87.7%
5541,Hamari Adhuri Kahani,498774,235361,263413,2015.csv,2015,47.2%,52.8%
5542,Whisper of the Heart 2019 Re-release,498156,498156,0,2019.csv,2019,100%,-
5543,The Five Senses,497091,497091,0,2000.csv,2000,100%,-
5544,The Prophet 2015 Re-release,496914,370146,126768,2015.csv,2015,74.5%,25.5%
5545,Félix & Meira,496714,447353,49361,2015.csv,2015,90.1%,9.9%
5546,April and the Extraordinary World,495879,295488,200391,2015.csv,2015,59.6%,40.4%
5547,Nausicaä of the Valley of the Wind 2019 Re-release,495770,495770,0,2019.csv,2019,100%,-
5548,Eden,494949,65460,429489,2014.csv,2014,13.2%,86.8%
5549,The Invisible Circus,494630,77578,417052,2001.csv,2001,15.7%,84.3%
5550,Steve Jobs: The Man in the Machine,494506,494506,0,2015.csv,2015,100%,-
5551,À Tout de Suite,494030,248565,245465,2004.csv,2004,50.3%,49.7%
5552,L'incomparable mademoiselle C.,493905,493905,0,2004.csv,2004,100%,-
5553,Monty Python's Life of Brian 2019 Re-release,493822,161507,332315,2019.csv,2019,32.7%,67.3%
5554,The Polar Express 2013 IMAX Release,493776,493776,0,2013.csv,2013,100%,-
5555,Rain,492661,455164,37497,2002.csv,2002,92.4%,7.6%
5556,Two Night Stand,492332,18612,473720,2014.csv,2014,3.8%,96.2%
5557,Soul on a String,491294,3669,487625,2017.csv,2017,0.7%,99.3%
5558,Wolves,491154,12139,479015,2014.csv,2014,2.5%,97.5%
5559,I'll Sleep When I'm Dead,490964,360759,130205,2004.csv,2004,73.5%,26.5%
5560,Tape,490475,490475,0,2001.csv,2001,100%,-
5561,Joker,490291,169181,321110,2012.csv,2012,34.5%,65.5%
5562,Open Grave,489812,0,489812,2013.csv,2013,-,100%
5563,Brothers,489706,389220,100486,2004.csv,2004,79.5%,20.5%
5564,Zama,489692,200600,289092,2017.csv,2017,41%,59%
5565,L'amour fou,489126,312494,176632,2010.csv,2010,63.9%,36.1%
5566,What Richard Did,488327,2749,485578,2012.csv,2012,0.6%,99.4%
5567,Asa Nu Maan Watna Da: In Search of Our Roots,487893,235075,252818,2004.csv,2004,48.2%,51.8%
5568,At Any Price,487455,380594,106861,2013.csv,2013,78.1%,21.9%
5569,London Fields,487420,252676,234744,2018.csv,2018,51.8%,48.2%
5570,Beach Rats,486623,473771,12852,2017.csv,2017,97.4%,2.6%
5571,Kisna: The Warrior Poet,485613,147000,338613,2005.csv,2005,30.3%,69.7%
5572,Cooties,485544,60058,425486,2015.csv,2015,12.4%,87.6%
5573,The Russian Five,485049,485049,0,2019.csv,2019,100%,-
5574,In Praise of Love,485003,252074,232929,2001.csv,2001,52%,48%
5575,Our Little Sister 2016 Re-release,483559,467555,16004,2016.csv,2016,96.7%,3.3%
5576,Lawrence of Arabia 2019 Re-release,482281,482281,0,2019.csv,2019,100%,-
5577,The Journey,482209,155475,326734,2017.csv,2017,32.2%,67.8%
5578,Tere Naal Love Ho Gaya,481796,177743,304053,2012.csv,2012,36.9%,63.1%
5579,I Origins,481234,336472,144762,2014.csv,2014,69.9%,30.1%
5580,Breathe In,481079,89661,391418,2013.csv,2013,18.6%,81.4%
5581,Father of My Children,480834,144022,336812,2010.csv,2010,30%,70%
5582,The Cuckoo,480578,243936,236642,2002.csv,2002,50.8%,49.2%
5583,The Third Man 2015 Re-release,478945,449191,29754,2015.csv,2015,93.8%,6.2%
5584,Brotherly Love,478595,478595,0,2015.csv,2015,100%,-
5585,The Last September,478053,478053,0,2000.csv,2000,100%,-
5586,Liam Gallagher: As It Was,477009,0,477009,2019.csv,2019,-,100%
5587,Blue Car,476551,465310,11241,2003.csv,2003,97.6%,2.4%
5588,Heart of a Dog,476384,420813,55571,2015.csv,2015,88.3%,11.7%
5589,The Babymakers,475511,7889,467622,2012.csv,2012,1.7%,98.3%
5590,Producing Adults,474752,935,473817,2004.csv,2004,0.2%,99.8%
5591,On the Job,472890,164620,308270,2013.csv,2013,34.8%,65.2%
5592,Pearl Jam Twenty,471334,471334,0,2011.csv,2011,100%,-
5593,Reconstruction,471107,73516,397591,2003.csv,2003,15.6%,84.4%
5594,About Elly 2015 Re-release,470760,470760,0,2015.csv,2015,100%,-
5595,White Bird in a Blizzard,469701,33821,435880,2014.csv,2014,7.2%,92.8%
5596,Matangi/Maya/M.I.A,469489,230808,238681,2018.csv,2018,49.2%,50.8%
5597,Joe Gould's Secret,468684,468684,0,2000.csv,2000,100%,-
5598,DCI 2017 Tour Premeire,467817,467817,0,2017.csv,2017,100%,-
5599,Hail Satan?,467232,424284,42948,2019.csv,2019,90.8%,9.2%
5600,Tully,466664,466664,0,2002.csv,2002,100%,-
5601,Last Days in Vietnam,466114,466114,0,2014.csv,2014,100%,-
5602,Neighboring Sounds,465082,60255,404827,2012.csv,2012,13%,87%
5603,Venus Beauty,465080,465080,0,2000.csv,2000,100%,-
5604,Ghanchakkar,464803,203044,261759,2013.csv,2013,43.7%,56.3%
5605,Puffs: Filmed Live Off Broadway,464483,464483,0,2018.csv,2018,100%,-
5606,Rififi 2000 Re-release,463593,460226,3367,2000.csv,2000,99.3%,0.7%
5607,Demonlover,462976,232044,230932,2002.csv,2002,50.1%,49.9%
5608,Deepsea Challenge 3D,462959,235659,227300,2014.csv,2014,50.9%,49.1%
5609,Before We Go,462875,37151,425724,2015.csv,2015,8%,92%
5610,The Bag Man,461780,56574,405206,2014.csv,2014,12.3%,87.7%
5611,MFKZ,461724,229423,232301,2018.csv,2018,49.7%,50.3%
5612,Scotty and the Secret History of Hollywood,461689,461689,0,2018.csv,2018,100%,-
5613,Outfoxed: Rupert Murdoch's War on Journalism,461572,461572,0,2004.csv,2004,100%,-
5614,Bully,461405,279202,182203,2012.csv,2012,60.5%,39.5%
5615,Disorder,460997,51879,409118,2015.csv,2015,11.3%,88.7%
5616,Manglehorn,459636,143101,316535,2015.csv,2015,31.1%,68.9%
5617,Christmas Jars,459462,459462,0,2019.csv,2019,100%,-
5618,Eric Clapton: A Life in 12 Bars,459088,0,459088,2017.csv,2017,-,100%
5619,The Legend of Suriyothai,458564,454736,3828,2003.csv,2003,99.2%,0.8%
5620,Shade,458144,25032,433112,2004.csv,2004,5.5%,94.5%
5621,The Memory of a Killer 2005 Re-release,458042,333707,124335,2005.csv,2005,72.9%,27.1%
5622,South Pacific 2018 Re-release,458000,458000,0,2018.csv,2018,100%,-
5623,We Steal Secrets: The Story of WikiLeaks,457517,166243,291274,2013.csv,2013,36.3%,63.7%
5624,Paradise: Hope,457132,6701,450431,2013.csv,2013,1.5%,98.5%
5625,Sound of Noise,456366,24565,431801,2010.csv,2010,5.4%,94.6%
5626,Staying Vertical,456271,12158,444113,2016.csv,2016,2.7%,97.3%
5627,Lola Versus,455754,252603,203151,2012.csv,2012,55.4%,44.6%
5628,The Gospel According to André,454550,400713,53837,2018.csv,2018,88.2%,11.8%
5629,The Most Dangerous Man in America: Daniel Ellsberg and the Pentagon Papers,453993,453993,0,2010.csv,2010,100%,-
5630,Warm Water Under a Red Bridge,453754,71094,382660,2001.csv,2001,15.7%,84.3%
5631,The Safety of Objects,453292,319299,133993,2002.csv,2002,70.4%,29.6%
5632,Ten,452895,105990,346905,2002.csv,2002,23.4%,76.6%
5633,Leaning Into The Wind,452372,400530,51842,2018.csv,2018,88.5%,11.5%
5634,Sailor Moon R: The Movie: The Promise of the Rose,452053,452053,0,2017.csv,2017,100%,-
5635,The Perfect Host,450885,48764,402121,2011.csv,2011,10.8%,89.2%
5636,Perfect Blue 2017 Re-release,450594,446062,4532,2017.csv,2017,99%,1%
5637,Kill List,450275,29063,421212,2011.csv,2011,6.5%,93.5%
5638,Pearl Jam: Let's Play Two,450273,348833,101440,2017.csv,2017,77.5%,22.5%
5639,Hesher,449702,382946,66756,2011.csv,2011,85.2%,14.8%
5640,17 Girls,449626,15123,434503,2011.csv,2011,3.4%,96.6%
5641,Lockdown,449482,449482,0,2003.csv,2003,100%,-
5642,The Rocket,449064,56823,392241,2013.csv,2013,12.7%,87.3%
5643,Before We Vanish,448829,52087,396742,2017.csv,2017,11.6%,88.4%
5644,The Sleeping Beauty,446131,29066,417065,2011.csv,2011,6.5%,93.5%
5645,I Am Trying to Break Your Heart,445522,445522,0,2002.csv,2002,100%,-
5646,Cruel Intentions 2019 Re-release,445218,445218,0,2019.csv,2019,100%,-
5647,Baise-moi,444243,420224,24019,2000.csv,2000,94.6%,5.4%
5648,Charlie Countryman,443990,11650,432340,2013.csv,2013,2.6%,97.4%
5649,Modern Times 2003 Re-release,443427,163577,279850,2003.csv,2003,36.9%,63.1%
5650,It's All About Love,443400,6140,437260,2003.csv,2003,1.4%,98.6%
5651,Porco Rosso 2018 Re-release,443059,443059,0,2018.csv,2018,100%,-
5652,The Beautiful Country 2005 Re-release,442813,442813,0,2005.csv,2005,100%,-
5653,Prince Avalanche,442313,205139,237174,2013.csv,2013,46.4%,53.6%
5654,Elf 2018 Re-release,442073,442073,0,2018.csv,2018,100%,-
5655,Aitraaz,440684,91998,348686,2004.csv,2004,20.9%,79.1%
5656,Bastards,439935,24525,415410,2013.csv,2013,5.6%,94.4%
5657,Short Cut to Nirvana: Kumbh Mela,439651,381225,58426,2004.csv,2004,86.7%,13.3%
5658,Bitch Slap,439587,17365,422222,2010.csv,2010,4%,96%
5659,Desert Dancer,438165,155271,282894,2014.csv,2014,35.4%,64.6%
5660,Dorm Daze,436365,56127,380238,2003.csv,2003,12.9%,87.1%
5661,My Kingdom,435759,36533,399226,2011.csv,2011,8.4%,91.6%
5662,The Singing Detective,435625,337174,98451,2003.csv,2003,77.4%,22.6%
5663,The Wayward Cloud,435251,0,435251,2005.csv,2005,-,100%
5664,We the Animals,434743,400961,33782,2018.csv,2018,92.2%,7.8%
5665,Moolaadé,434553,215646,218907,2004.csv,2004,49.6%,50.4%
5666,What We Left Behind: Star Trek DS9,434437,382457,51980,2019.csv,2019,88%,12%
5667,Chaos 2002 Re-release,434432,206789,227643,2002.csv,2002,47.6%,52.4%
5668,DCI 2018 Tour Premeire,434008,434008,0,2018.csv,2018,100%,-
5669,Rosenwald,433924,433924,0,2015.csv,2015,100%,-
5670,Björk: Biophilia Live,433686,127754,305932,2014.csv,2014,29.5%,70.5%
5671,I Want Your Money,433588,433588,0,2010.csv,2010,100%,-
5672,The Sower,433112,36233,396879,2018.csv,2018,8.4%,91.6%
5673,Little Jerusalem,431623,53580,378043,2005.csv,2005,12.4%,87.6%
5674,Promises,430862,247948,182914,2002.csv,2002,57.5%,42.5%
5675,Harmony,430568,23248,407320,2015.csv,2015,5.4%,94.6%
5676,Andy Irons: Kissed by God,430393,285933,144460,2018.csv,2018,66.4%,33.6%
5677,Go Goa Gone,429350,298457,130893,2013.csv,2013,69.5%,30.5%
5678,On the Beach at Night Alone,429159,37489,391670,2017.csv,2017,8.7%,91.3%
5679,Blackway,426491,27079,399412,2016.csv,2016,6.3%,93.7%
5680,Happy Bhaag Jayegi 2016 Re-release,426345,351840,74505,2016.csv,2016,82.5%,17.5%
5681,Josh,426318,426318,0,2000.csv,2000,100%,-
5682,Killing Sarai,425332,425332,0,2019.csv,2019,100%,-
5683,8 ½ Women,424123,424123,0,2000.csv,2000,100%,-
5684,Sound of My Voice,424088,408015,16073,2012.csv,2012,96.2%,3.8%
5685,Viva,423976,178008,245968,2016.csv,2016,42%,58%
5686,God Help the Girl,423306,102757,320549,2014.csv,2014,24.3%,75.7%
5687,Taking Sides,422832,188952,233880,2002.csv,2002,44.7%,55.3%
5688,Cirque du Soleil in Cinema: KURIOS - Cabinet of Curiosities,422760,413039,9721,2018.csv,2018,97.7%,2.3%
5689,Mississippi Grind,422746,130541,292205,2015.csv,2015,30.9%,69.1%
5690,Behaving Badly,422697,0,422697,2014.csv,2014,-,100%
5691,Ben-Hur 2019 Re-release,422622,422622,0,2019.csv,2019,100%,-
5692,Super,422618,327716,94902,2011.csv,2011,77.5%,22.5%
5693,Settai,422247,87838,334409,2013.csv,2013,20.8%,79.2%
5694,Mad Max: Fury Road 2016 Re-release,421986,421986,0,2016.csv,2016,100%,-
5695,She's Beautiful When She's Angry,421573,421573,0,2014.csv,2014,100%,-
5696,Porn Star: The Legend of Ron Jeremy,421516,421516,0,2001.csv,2001,100%,-
5697,The Bounce Back,421404,321910,99494,2016.csv,2016,76.4%,23.6%
5698,The Cold Blue,420177,420177,0,2019.csv,2019,100%,-
5699,Voiceless,419952,419952,0,2016.csv,2016,100%,-
5700,Madame Satã,419046,198309,220737,2002.csv,2002,47.3%,52.7%
5701,Amandla! A Revolution in Four Part Harmony,418941,405331,13610,2003.csv,2003,96.8%,3.2%
5702,Frankenstein 2018 Re-release,417783,417783,0,2018.csv,2018,100%,-
5703,Happy Phirr Bhag Jayegi,417669,103385,314284,2018.csv,2018,24.8%,75.2%
5704,In the Realms of the Unreal,417120,417120,0,2004.csv,2004,100%,-
5705,Dirty Wars,416853,384473,32380,2013.csv,2013,92.2%,7.8%
5706,Tales of Halloween,416792,0,416792,2015.csv,2015,-,100%
5707,Manifesto,416389,161101,255288,2017.csv,2017,38.7%,61.3%
5708,Status Update,416178,4764,411414,2018.csv,2018,1.1%,98.9%
5709,Sand Storm,414698,86800,327898,2016.csv,2016,20.9%,79.1%
5710,Wonderland,414254,414254,0,2000.csv,2000,100%,-
5711,The Ottoman Lieutenant,413844,240978,172866,2017.csv,2017,58.2%,41.8%
5712,The Mafia Kills Only in Summer 2015 Re-release,413236,37134,376102,2015.csv,2015,9%,91%
5713,The Moth Diaries,413035,3838,409197,2012.csv,2012,0.9%,99.1%
5714,Unbranded,412792,410185,2607,2015.csv,2015,99.4%,0.6%
5715,Godzilla,412520,412520,0,2004.csv,2004,100%,-
5716,Rage,411967,5594,406373,2010.csv,2010,1.4%,98.6%
5717,Tuvalu,411678,411678,0,2001.csv,2001,100%,-
5718,R... Rajkumar,410495,166503,243992,2013.csv,2013,40.6%,59.4%
5719,El bonaerense,410474,9470,401004,2002.csv,2002,2.3%,97.7%
5720,Free Zone,410392,32381,378011,2005.csv,2005,7.9%,92.1%
5721,Mobsters and Mormons,409604,409604,0,2005.csv,2005,100%,-
5722,City of Revenge,409166,409166,0,2015.csv,2015,100%,-
5723,Song One,408918,32251,376667,2015.csv,2015,7.9%,92.1%
5724,The Reliant,408747,408747,0,2019.csv,2019,100%,-
5725,Sleeping Beauty,408680,36578,372102,2011.csv,2011,9%,91%
5726,Vertigo 2018 Re-release,408560,394212,14348,2018.csv,2018,96.5%,3.5%
5727,The 5th Quarter,408159,408159,0,2011.csv,2011,100%,-
5728,Le Cercle Rouge,407878,369970,37908,2002.csv,2002,90.7%,9.3%
5729,"Love, Kennedy",407871,407871,0,2017.csv,2017,100%,-
5730,Cinema Paradiso 2002 Re-release,406809,406809,0,2002.csv,2002,100%,-
5731,Please Stand By,406732,9868,396864,2018.csv,2018,2.4%,97.6%
5732,Chasing Trane: The John Coltrane Documentary,406284,406284,0,2017.csv,2017,100%,-
5733,Gabrielle,406256,5534,400722,2013.csv,2013,1.4%,98.6%
5734,Har Dil Jo Pyar Karega...,406235,406235,0,2000.csv,2000,100%,-
5735,The Square 2010 Re-release,406116,406116,0,2010.csv,2010,100%,-
5736,The Hunting Ground,405917,405917,0,2015.csv,2015,100%,-
5737,The Tempest,405861,277943,127918,2010.csv,2010,68.5%,31.5%
5738,Stake Land,405380,33245,372135,2011.csv,2011,8.2%,91.8%
5739,Happy Magic,405268,10697,394571,2011.csv,2011,2.6%,97.4%
5740,Tezz,405214,229931,175283,2012.csv,2012,56.7%,43.3%
5741,The Philadelphia Story 2018 Re-release,404524,404524,0,2018.csv,2018,100%,-
5742,God's Pocket,403713,169976,233737,2014.csv,2014,42.1%,57.9%
5743,A Wake in Providence,403069,403069,0,2005.csv,2005,100%,-
5744,The Apu Trilogy,402723,402723,0,2015.csv,2015,100%,-
5745,The Brown Bunny,402599,366301,36298,2004.csv,2004,91%,9%
5746,Raju Chacha,402226,194698,207528,2000.csv,2000,48.4%,51.6%
5747,Gang Land,402000,402000,0,2000.csv,2000,100%,-
5748,Drinking Buddies,401914,343341,58573,2013.csv,2013,85.4%,14.6%
5749,The Oath,401463,401463,0,2018.csv,2018,100%,-
5750,Freetown,401328,401328,0,2015.csv,2015,100%,-
5751,An Affair of Love,401299,359050,42249,2000.csv,2000,89.5%,10.5%
5752,"Hello, Dolly!",400881,400881,0,2019.csv,2019,100%,-
5753,Crimson Gold,400768,148959,251809,2004.csv,2004,37.2%,62.8%
5754,Racer and the Jailbird,400026,46337,353689,2017.csv,2017,11.6%,88.4%
5755,The Mystic Masseur,399110,399110,0,2002.csv,2002,100%,-
5756,West Side Story 2018 Re-release,398670,398670,0,2018.csv,2018,100%,-
5757,Space Mutiny,397887,397887,0,2018.csv,2018,100%,-
5758,Berlin Syndrome,397783,28660,369123,2017.csv,2017,7.2%,92.8%
5759,Krull 2018 Re-release,397157,397157,0,2018.csv,2018,100%,-
5760,Lost and Delirious,396897,307233,89664,2001.csv,2001,77.4%,22.6%
5761,Still We Believe: The Boston Red Sox Movie,396803,396803,0,2004.csv,2004,100%,-
5762,Very Annie Mary,396090,46352,349738,2002.csv,2002,11.7%,88.3%
5763,13 Minutes 2015 Re-release,395557,161531,234026,2015.csv,2015,40.8%,59.2%
5764,Pauline and Paulette,395175,139789,255386,2001.csv,2001,35.4%,64.6%
5765,Keane,394390,33256,361134,2005.csv,2005,8.4%,91.6%
5766,The Yes Men,394154,255364,138790,2004.csv,2004,64.8%,35.2%
5767,God Bless America,393880,122550,271330,2012.csv,2012,31.1%,68.9%
5768,Into the Abyss,393714,223880,169834,2011.csv,2011,56.9%,43.1%
5769,Millennium Mambo,393351,14904,378447,2001.csv,2001,3.8%,96.2%
5770,Jee Aayan Nu,393117,393117,0,2002.csv,2002,100%,-
5771,Cuban Fury 2014 Re-release,392705,92384,300321,2014.csv,2014,23.5%,76.5%
5772,Hamara Dil Aapke Paas Hai,392076,392076,0,2000.csv,2000,100%,-
5773,Te3n,391957,331507,60450,2016.csv,2016,84.6%,15.4%
5774,End of the Century,391950,391950,0,2004.csv,2004,100%,-
5775,Tiny Furniture,391674,391674,0,2010.csv,2010,100%,-
5776,Bittersweet Motel,391653,391653,0,2000.csv,2000,100%,-
5777,The Escape,390881,14018,376863,2018.csv,2018,3.6%,96.4%
5778,Detropia,390024,390024,0,2012.csv,2012,100%,-
5779,Once Upon a Time in Mumbai Dobaara!,389237,0,389237,2013.csv,2013,-,100%
5780,House of D,389199,388532,667,2005.csv,2005,99.8%,0.2%
5781,The Game of Their Lives,388998,375750,13248,2005.csv,2005,96.6%,3.4%
5782,Singh Saab the Great,388622,225668,162954,2013.csv,2013,58.1%,41.9%
5783,Keep the Lights On,388331,246112,142219,2012.csv,2012,63.4%,36.6%
5784,"Westwood: Punk, Icon, Activist",386856,58979,327877,2018.csv,2018,15.2%,84.8%
5785,Hitchcock/Truffaut,386471,260430,126041,2015.csv,2015,67.4%,32.6%
5786,The Wedding Guest,386166,386166,0,2019.csv,2019,100%,-
5787,How To Talk To Girls at Parties,385733,84809,300924,2018.csv,2018,22%,78%
5788,Samurai Cop,384756,384756,0,2017.csv,2017,100%,-
5789,Bethlehem,384670,201700,182970,2014.csv,2014,52.4%,47.6%
5790,The Embalmer,384336,56878,327458,2002.csv,2002,14.8%,85.2%
5791,The Secret World of Arrietty 2019 Re-release,384289,384289,0,2019.csv,2019,100%,-
5792,"Scotland, Pa.",384098,384098,0,2002.csv,2002,100%,-
5793,Imagining Argentina,383106,8899,374207,2003.csv,2003,2.3%,97.7%
5794,Into the Arms of Strangers,382807,382807,0,2000.csv,2000,100%,-
5795,Digimon Adventure tri. Part 5: Coexistence,382119,52339,329780,2017.csv,2017,13.7%,86.3%
5796,Game,381911,139528,242383,2011.csv,2011,36.5%,63.5%
5797,Z for Zachariah,381839,121461,260378,2015.csv,2015,31.8%,68.2%
5798,The Children of the Century,381624,56611,325013,2002.csv,2002,14.8%,85.2%
5799,Flower,380553,328188,52365,2018.csv,2018,86.2%,13.8%
5800,Jane and Emma,380030,380030,0,2018.csv,2018,100%,-
5801,Daughter of Mine,379010,10628,368382,2018.csv,2018,2.8%,97.2%
5802,I'll Push You: A Real-Life Inspiration,378899,378899,0,2017.csv,2017,100%,-
5803,Blind Spot. Hitler's Secretary,378382,378382,0,2003.csv,2003,100%,-
5804,Miss Hokusai,377702,222670,155032,2015.csv,2015,59%,41%
5805,Attack on Titan: Smoke Signal,377334,377334,0,2018.csv,2018,100%,-
5806,Pride and Prejudice,377271,377271,0,2003.csv,2003,100%,-
5807,Hochelaga,376714,376714,0,2000.csv,2000,100%,-
5808,The Hunting of the President,376612,376612,0,2004.csv,2004,100%,-
5809,The Nightmare Before Christmas 2000 Re-release,376586,376586,0,2000.csv,2000,100%,-
5810,Le talent de mes amis,376522,889,375633,2015.csv,2015,0.2%,99.8%
5811,Born Romantic,376090,15545,360545,2001.csv,2001,4.1%,95.9%
5812,The Dark Knight 2018 Re-release,375589,375589,0,2018.csv,2018,100%,-
5813,The Metropolitan Opera HD Live: Puccini: Turandot,375295,0,375295,2019.csv,2019,-,100%
5814,Chronic,374704,9033,365671,2016.csv,2016,2.4%,97.6%
5815,Annie Brocoli dans les fonds marins,374360,374360,0,2003.csv,2003,100%,-
5816,Waking Up in Reno,374312,267109,107203,2002.csv,2002,71.4%,28.6%
5817,Jurassic Park 2018 Re-release,374238,374238,0,2018.csv,2018,100%,-
5818,Keep the River on Your Right: A Modern Cannibal Tale,373366,373366,0,2001.csv,2001,100%,-
5819,Nico and Dani,372850,370562,2288,2001.csv,2001,99.4%,0.6%
5820,Pom Poko 2018 Re-release,372405,372405,0,2018.csv,2018,100%,-
5821,Eloise,372137,0,372137,2017.csv,2017,-,100%
5822,Fanny,371657,8735,362922,2013.csv,2013,2.4%,97.6%
5823,Havoc,371000,0,371000,2005.csv,2005,-,100%
5824,7 Boxes,370892,38106,332786,2013.csv,2013,10.3%,89.7%
5825,Hava Nagila: The Movie,370218,370218,0,2013.csv,2013,100%,-
5826,Me Myself I,369975,369975,0,2000.csv,2000,100%,-
5827,"Ruben Brandt, Collector 2018 Re-release",369809,117963,251846,2018.csv,2018,31.9%,68.1%
5828,Ghostbusters 2019 Re-release,369612,369612,0,2019.csv,2019,100%,-
5829,Me Without You,369226,304909,64317,2001.csv,2001,82.6%,17.4%
5830,Mooz-Lum,369129,369129,0,2011.csv,2011,100%,-
5831,When Comedy Went to School,369065,369065,0,2013.csv,2013,100%,-
5832,The Void,368372,151042,217330,2017.csv,2017,41%,59%
5833,Dark Awakening,367925,0,367925,2015.csv,2015,-,100%
5834,Room 237,367406,296359,71047,2012.csv,2012,80.7%,19.3%
5835,The Big White,367241,0,367241,2005.csv,2005,-,100%
5836,INXS: Baby Live at Wembly Stadium,366425,161750,204675,2019.csv,2019,44.1%,55.9%
5837,The Animation Show,366344,366344,0,2003.csv,2003,100%,-
5838,First Love,366247,218329,147918,2019.csv,2019,59.6%,40.4%
5839,Grease 2010 Sing-a-long,365802,365802,0,2010.csv,2010,100%,-
5840,Baadasssss!,365727,365727,0,2004.csv,2004,100%,-
5841,7 Khoon Maaf,365672,270207,95465,2011.csv,2011,73.9%,26.1%
5842,Eat That Question,365540,355074,10466,2016.csv,2016,97.1%,2.9%
5843,Glen Campbell: I'll Be Me,365422,365422,0,2014.csv,2014,100%,-
5844,Lords of Chaos,365353,253184,112169,2019.csv,2019,69.3%,30.7%
5845,Tera Jadoo Chal Gayaa,365318,365318,0,2000.csv,2000,100%,-
5846,Clemency,364716,364716,0,2019.csv,2019,100%,-
5847,BOSTON: An American Running Story,364369,364369,0,2017.csv,2017,100%,-
5848,The Adventures of Felix,363409,363409,0,2001.csv,2001,100%,-
5849,Jig,363320,183790,179530,2011.csv,2011,50.6%,49.4%
5850,The Breadwinner,363307,312381,50926,2017.csv,2017,86%,14%
5851,Scorched,363057,8000,355057,2003.csv,2003,2.2%,97.8%
5852,Breathless 2010 Re-release,363031,363031,0,2010.csv,2010,100%,-
5853,Happy Times,361000,240093,120907,2002.csv,2002,66.5%,33.5%
5854,Grateful Dawg,360251,360251,0,2001.csv,2001,100%,-
5855,These Final Hours,360234,0,360234,2014.csv,2014,-,100%
5856,Souvenir,359798,11411,348387,2016.csv,2016,3.2%,96.8%
5857,Disney Junior HalloVeen Party!,359745,359745,0,2017.csv,2017,100%,-
5858,Happy Ending,359542,313770,45772,2014.csv,2014,87.3%,12.7%
5859,K-12,359377,303230,56147,2019.csv,2019,84.4%,15.6%
5860,Sarkar 3,358928,249588,109340,2017.csv,2017,69.5%,30.5%
5861,The Shawshank Redemption 2019 Re-release,358507,358507,0,2019.csv,2019,100%,-
5862,Love in Space,358486,34787,323699,2011.csv,2011,9.7%,90.3%
5863,Everly,358156,0,358156,2015.csv,2015,-,100%
5864,Welcome to the Rileys,358014,158898,199116,2010.csv,2010,44.4%,55.6%
5865,National Gallery,354971,253941,101030,2014.csv,2014,71.5%,28.5%
5866,Hello I Must Be Going,354939,106709,248230,2012.csv,2012,30.1%,69.9%
5867,The Invitation,354835,231737,123098,2016.csv,2016,65.3%,34.7%
5868,Kaashmora,354631,327959,26672,2016.csv,2016,92.5%,7.5%
5869,Las Acacias,354391,6000,348391,2011.csv,2011,1.7%,98.3%
5870,The Tomorrow Man,354103,354103,0,2019.csv,2019,100%,-
5871,"Broadway: The Golden Age, by the Legends Who Were There",353580,353580,0,2004.csv,2004,100%,-
5872,How My Mother Gave Birth to Me During Menopause,353275,353275,0,2003.csv,2003,100%,-
5873,Like Dandelion Dust,352810,352810,0,2010.csv,2010,100%,-
5874,Lumumba,352296,352296,0,2001.csv,2001,100%,-
5875,Long Strange Trip - The Untold Story of The Grateful Dead,351957,351957,0,2017.csv,2017,100%,-
5876,The Wizard of Oz 2018 Re-release,351839,351839,0,2018.csv,2018,100%,-
5877,Yossi & Jagger,351707,267005,84702,2003.csv,2003,75.9%,24.1%
5878,The Chumscrubber,351401,52597,298804,2005.csv,2005,15%,85%
5879,Bel Canto,350264,125569,224695,2018.csv,2018,35.8%,64.2%
5880,Aferim!,350110,108110,242000,2015.csv,2015,30.9%,69.1%
5881,Howards End 2016 Re-release,349993,160282,189711,2016.csv,2016,45.8%,54.2%
5882,Tehran Taboo,349886,74758,275128,2017.csv,2017,21.4%,78.6%
5883,Satanic,349183,252,348931,2016.csv,2016,<0.1%,99.9%
5884,Marie's Story 2014 Re-release,348906,11720,337186,2014.csv,2014,3.4%,96.6%
5885,Suicide the Ripple Effect,347468,347468,0,2018.csv,2018,100%,-
5886,The Good Heart,346851,20930,325921,2010.csv,2010,6%,94%
5887,The Vault,346729,5728,341001,2017.csv,2017,1.7%,98.3%
5888,Star Trek 2019 Re-release,346243,346243,0,2019.csv,2019,100%,-
5889,Triple Threat,345900,76289,269611,2019.csv,2019,22.1%,77.9%
5890,Billabong Odyssey,345708,156000,189708,2003.csv,2003,45.1%,54.9%
5891,Bear Cub,345693,100133,245560,2004.csv,2004,29%,71%
5892,Anatomy of Hell,345365,34506,310859,2004.csv,2004,10%,90%
5893,The Dying Gaul,345041,342747,2294,2005.csv,2005,99.3%,0.7%
5894,American Adobo,344992,344992,0,2002.csv,2002,100%,-
5895,The United States of Leland,343847,343847,0,2004.csv,2004,100%,-
5896,Countdown to Canelo vs. Chavez Jr.,343387,343387,0,2017.csv,2017,100%,-
5897,El Bulli: Cooking in Progress,343116,237181,105935,2011.csv,2011,69.1%,30.9%
5898,The Idol,343059,0,343059,2016.csv,2016,-,100%
5899,Koch,342941,342941,0,2013.csv,2013,100%,-
5900,"Life, Animated",342664,255388,87276,2016.csv,2016,74.5%,25.5%
5901,Lawrence of Arabia 2002 Re-release,342481,342481,0,2002.csv,2002,100%,-
5902,Nureyev: Lifting the Curtain,342255,165203,177052,2018.csv,2018,48.3%,51.7%
5903,Knife + Heart,341847,32516,309331,2018.csv,2018,9.5%,90.5%
5904,Dangerous People,341280,341280,0,2002.csv,2002,100%,-
5905,Bolshoi Ballet: Swan Lake,341058,88905,252153,2018.csv,2018,26.1%,73.9%
5906,The Lady in the Car with Glasses and a Gun,339461,2167,337294,2015.csv,2015,0.6%,99.4%
5907,The Green Prince,339208,258237,80971,2014.csv,2014,76.1%,23.9%
5908,Happy People: A Year in the Taiga,338987,338987,0,2013.csv,2013,100%,-
5909,Red Hook Summer,338803,338803,0,2012.csv,2012,100%,-
5910,Is It Wrong to Try to Pick Up Girls in a Dungeon - Arrow of the Orion,338632,271489,67143,2019.csv,2019,80.2%,19.8%
5911,Silencio,338596,158723,179873,2018.csv,2018,46.9%,53.1%
5912,Winter Solstice,337617,319355,18262,2005.csv,2005,94.6%,5.4%
5913,Ran 2000 Re-release,337587,337587,0,2000.csv,2000,100%,-
5914,Dark Horse,337150,166228,170922,2012.csv,2012,49.3%,50.7%
5915,The Last Waltz 2002 Re-release,337085,322313,14772,2002.csv,2002,95.6%,4.4%
5916,Voyage of Time: The IMAX Experience,337038,55409,281629,2016.csv,2016,16.4%,83.6%
5917,Kings of Pastry,336386,336386,0,2010.csv,2010,100%,-
5918,Diane,336166,336166,0,2019.csv,2019,100%,-
5919,Wooly Boys,335726,335726,0,2004.csv,2004,100%,-
5920,Sailor Moon R: The Movie: The Promise of the Rose/Sailor Moon S: The Movie - Hearts in Ice,335697,335697,0,2018.csv,2018,100%,-
5921,Freaks,335050,276591,58459,2019.csv,2019,82.6%,17.4%
5922,Russ Taff: I Still Believe,334983,334983,0,2018.csv,2018,100%,-
5923,Anthropocene: The Human Epoch,334162,104806,229356,2019.csv,2019,31.4%,68.6%
5924,A Silent Voice: The Movie 2019 Re-release,333984,333984,0,2019.csv,2019,100%,-
5925,Dark Days,333843,309648,24195,2000.csv,2000,92.8%,7.2%
5926,Ballet 422,333554,333554,0,2015.csv,2015,100%,-
5927,Shine,333388,333388,0,2018.csv,2018,100%,-
5928,Something from Nothing: The Art of Rap,333388,288000,45388,2012.csv,2012,86.4%,13.6%
5929,Linsanity,332990,302645,30345,2013.csv,2013,90.9%,9.1%
5930,Don't Hang Up,332571,0,332571,2017.csv,2017,-,100%
5931,Shamitabh,331821,324597,7224,2015.csv,2015,97.8%,2.2%
5932,I Am David,329577,288552,41025,2004.csv,2004,87.6%,12.4%
5933,Bukowski: Born into This,329097,318816,10281,2004.csv,2004,96.9%,3.1%
5934,The Big Fight Live: IBF Welterweight Title: Errol Spence Jr. vs. Mikey Garcia,328979,328979,0,2019.csv,2019,100%,-
5935,Ladies vs. Ricky Bahl,328870,0,328870,2011.csv,2011,-,100%
5936,The Last Sentence,328005,62506,265499,2012.csv,2012,19.1%,80.9%
5937,Elaine Stritch: Shoot Me,327452,327452,0,2014.csv,2014,100%,-
5938,Come Undone,326484,326484,0,2001.csv,2001,100%,-
5939,You Will Be My Son 2012 Re-release,326061,285151,40910,2012.csv,2012,87.5%,12.5%
5940,Formosa Betrayed,326034,225341,100693,2010.csv,2010,69.1%,30.9%
5941,Lucy in the Sky,325950,319976,5974,2019.csv,2019,98.2%,1.8%
5942,The Central Park Five,325653,325653,0,2012.csv,2012,100%,-
5943,The Opera House,325235,320079,5156,2018.csv,2018,98.4%,1.6%
5944,Camp,324977,324977,0,2013.csv,2013,100%,-
5945,Juan of the Dead,324834,18000,306834,2012.csv,2012,5.5%,94.5%
5946,Teefa In Trouble,324633,0,324633,2018.csv,2018,-,100%
5947,Red Hill,324424,21087,303337,2010.csv,2010,6.5%,93.5%
5948,The Bolshoi Ballet: Live From Moscow - The Nutcracker,323928,323928,0,2018.csv,2018,100%,-
5949,The Boys of Baraka,323860,323860,0,2005.csv,2005,100%,-
5950,The Cured,323776,26630,297146,2018.csv,2018,8.2%,91.8%
5951,Three Worlds,323748,3952,319796,2012.csv,2012,1.2%,98.8%
5952,Sword of Trust,323369,322421,948,2019.csv,2019,99.7%,0.3%
5953,Damsel,323235,305136,18099,2018.csv,2018,94.4%,5.6%
5954,Citizen Jane: Battle for the City,323124,313411,9713,2017.csv,2017,97%,3%
5955,Winter Sleepers,323041,323041,0,2000.csv,2000,100%,-
5956,The Day He Arrives,322348,13746,308602,2011.csv,2011,4.3%,95.7%
5957,In This World,322097,84299,237798,2003.csv,2003,26.2%,73.8%
5958,Nocturama,321768,30157,291611,2016.csv,2016,9.4%,90.6%
5959,The Weight of Water,321279,109130,212149,2001.csv,2001,34%,66%
5960,Double Trouble,321081,44788,276293,2012.csv,2012,13.9%,86.1%
5961,Woodstock,320610,126562,194048,2019.csv,2019,39.5%,60.5%
5962,A Film Unfinished,320486,320486,0,2010.csv,2010,100%,-
5963,Cunningham,320293,265102,55191,2019.csv,2019,82.8%,17.2%
5964,"Die, Mommie, Die!",320092,320092,0,2003.csv,2003,100%,-
5965,The English Teacher,320013,104810,215203,2013.csv,2013,32.8%,67.2%
5966,Meeting Gorbachev,319230,251837,67393,2019.csv,2019,78.9%,21.1%
5967,You Are Here: A Come From Away Story,318885,318885,0,2019.csv,2019,100%,-
5968,Neal 'N' Nikki,318860,111551,207309,2005.csv,2005,35%,65%
5969,Bride of the Wind,318823,318823,0,2001.csv,2001,100%,-
5970,The Yellow Handkerchief,318623,318623,0,2010.csv,2010,100%,-
5971,West of Memphis,318317,310154,8163,2012.csv,2012,97.4%,2.6%
5972,Ask Dr. Ruth,318230,297195,21035,2019.csv,2019,93.4%,6.6%
5973,The Student,318123,1126,316997,2016.csv,2016,0.4%,99.6%
5974,Not Today,318121,318121,0,2013.csv,2013,100%,-
5975,Today's Special,317831,317831,0,2010.csv,2010,100%,-
5976,Inch'Allah,317656,9840,307816,2013.csv,2013,3.1%,96.9%
5977,Sauvage / Wild,317536,61604,255932,2018.csv,2018,19.4%,80.6%
5978,6 Days,316946,0,316946,2017.csv,2017,-,100%
5979,5 Days of War,316944,17479,299465,2011.csv,2011,5.5%,94.5%
5980,AmeriGeddon,316554,316554,0,2016.csv,2016,100%,-
5981,The Aryan Couple,316527,290211,26316,2005.csv,2005,91.7%,8.3%
5982,Corpo Celeste 2011 Re-release,316504,8919,307585,2011.csv,2011,2.8%,97.2%
5983,The Riot and the Dance,316103,316103,0,2018.csv,2018,100%,-
5984,David and Goliath,316100,316100,0,2015.csv,2015,100%,-
5985,Under the Sun,316020,316020,0,2001.csv,2001,100%,-
5986,Action Jackson,315609,256872,58737,2014.csv,2014,81.4%,18.6%
5987,Josh Groban Bridges from Madison Square Garden,315173,315173,0,2019.csv,2019,100%,-
5988,Obit.,315049,315049,0,2017.csv,2017,100%,-
5989,Call,314701,314701,0,2000.csv,2000,100%,-
5990,America's Heart & Soul,314402,314402,0,2004.csv,2004,100%,-
5991,Elevator to the Gallows,314387,263404,50983,2005.csv,2005,83.8%,16.2%
5992,Time Out of Mind,314082,166775,147307,2015.csv,2015,53.1%,46.9%
5993,Russian Doll,313901,127103,186798,2001.csv,2001,40.5%,59.5%
5994,Christine,313465,298525,14940,2016.csv,2016,95.2%,4.8%
5995,War Witch,313387,70544,242843,2012.csv,2012,22.5%,77.5%
5996,The Bolshoi Ballet: Live From Moscow - Romeo and Juliet,313088,313088,0,2018.csv,2018,100%,-
5997,Grass,313039,313039,0,2000.csv,2000,100%,-
5998,Berberian Sound Studio,312757,38493,274264,2012.csv,2012,12.3%,87.7%
5999,The Hornet's Nest,312706,312706,0,2014.csv,2014,100%,-
6000,The Gatekeeper,312434,312434,0,2003.csv,2003,100%,-
6001,David Lynch: The Art Life,311470,171419,140051,2017.csv,2017,55%,45%
6002,Bolshoi Ballet: The Sleeping Beauty,311368,311368,0,2019.csv,2019,100%,-
6003,Plácido Domingo Gala,311246,52502,258744,2019.csv,2019,16.9%,83.1%
6004,Dancing in Jaffa,311001,151098,159903,2014.csv,2014,48.6%,51.4%
6005,Being Elmo: A Puppeteer's Journey,310812,304052,6760,2011.csv,2011,97.8%,2.2%
6006,I Am Eleven 2014 Re-release,310116,310116,0,2014.csv,2014,100%,-
6007,Pumpkin,308552,308552,0,2002.csv,2002,100%,-
6008,The Amazing Catfish,308349,11342,297007,2014.csv,2014,3.7%,96.3%
6009,Merchants of Doubt,308156,308156,0,2015.csv,2015,100%,-
6010,MET Opera: Magic Flute,307686,307686,0,2018.csv,2018,100%,-
6011,Never Again,307631,307631,0,2002.csv,2002,100%,-
6012,Dot the I,307486,307486,0,2005.csv,2005,100%,-
6013,The Trip,306567,306567,0,2003.csv,2003,100%,-
6014,Half of a Yellow Sun,306393,54529,251864,2014.csv,2014,17.8%,82.2%
6015,The Mercy 2018 Re-release,306205,29538,276667,2018.csv,2018,9.6%,90.4%
6016,Monsters: Dark Continent,306004,0,306004,2015.csv,2015,-,100%
6017,Under the Sun,305993,105036,200957,2016.csv,2016,34.3%,65.7%
6018,The Third Wife,305755,84933,220822,2019.csv,2019,27.8%,72.2%
6019,Hair Show,305281,305281,0,2004.csv,2004,100%,-
6020,Khushi,305205,305205,0,2003.csv,2003,100%,-
6021,Showtime Championship Boxing: Deontay Wilder vs. Tyson Fury,304482,304482,0,2018.csv,2018,100%,-
6022,Microbe & Gasoline,303787,63802,239985,2015.csv,2015,21%,79%
6023,NH10,303587,303587,0,2015.csv,2015,100%,-
6024,Alamar,303574,61613,241961,2010.csv,2010,20.3%,79.7%
6025,The Bolshoi Ballet: Live From Moscow - Giselle,302681,302681,0,2018.csv,2018,100%,-
6026,101 Reykjavík 2001 Re-release,301882,126404,175478,2001.csv,2001,41.9%,58.1%
6027,The Unknown Known,301604,276497,25107,2014.csv,2014,91.7%,8.3%
6028,Cliffs of Freedom,300842,72476,228366,2019.csv,2019,24.1%,75.9%
6029,Series 7: The Contenders,300086,195065,105021,2001.csv,2001,65%,35%
6030,Love's Labour's Lost,299792,299792,0,2000.csv,2000,100%,-
6031,Sunset Blvd. 2018 Re-release,299645,299645,0,2018.csv,2018,100%,-
6032,Cotton Mary,299432,299432,0,2000.csv,2000,100%,-
6033,Kedma,299293,10067,289226,2002.csv,2002,3.4%,96.6%
6034,Festival in Cannes,299171,299171,0,2002.csv,2002,100%,-
6035,Zhou Yu de huo che 2004 Re-release,298429,142562,155867,2004.csv,2004,47.8%,52.2%
6036,Jinn,297381,202348,95033,2014.csv,2014,68%,32%
6037,Kaptaan,296715,203790,92925,2016.csv,2016,68.7%,31.3%
6038,Bonhoeffer,296181,296181,0,2003.csv,2003,100%,-
6039,The We and the I,295930,42172,253758,2012.csv,2012,14.3%,85.7%
6040,Harry Potter and the Sorcerer's Stone 2018 Re-release,295917,295917,0,2018.csv,2018,100%,-
6041,Trixie,295683,295683,0,2000.csv,2000,100%,-
6042,Chic!,295295,5587,289708,2015.csv,2015,1.9%,98.1%
6043,Wet Hot American Summer,295206,295206,0,2001.csv,2001,100%,-
6044,The Tenth Man,295129,63564,231565,2016.csv,2016,21.5%,78.5%
6045,Mickey,294758,294758,0,2004.csv,2004,100%,-
6046,Aftershock,294696,58510,236186,2013.csv,2013,19.9%,80.1%
6047,Shakira in Concert: El Dorado World Tour,294677,271586,23091,2019.csv,2019,92.2%,7.8%
6048,Khodorkovsky,294599,39522,255077,2011.csv,2011,13.4%,86.6%
6049,Special Treatment,294483,8856,285627,2010.csv,2010,3%,97%
6050,44 Inch Chest 2010 Re-release,294245,39033,255212,2010.csv,2010,13.3%,86.7%
6051,Innocence,294039,294039,0,2014.csv,2014,100%,-
6052,Karthik Calling Karthik,293499,286409,7090,2010.csv,2010,97.6%,2.4%
6053,Okko's Inn,293385,134787,158598,2018.csv,2018,45.9%,54.1%
6054,The Giant Spider Invasion,293053,293053,0,2019.csv,2019,100%,-
6055,Pianomania,292870,49852,243018,2010.csv,2010,17%,83%
6056,Stonewall,292669,187674,104995,2015.csv,2015,64.1%,35.9%
6057,Luminarias,292309,292309,0,2000.csv,2000,100%,-
6058,Mesrine Part 2: Public Enemy #1 2010 Re-release,292150,275387,16763,2010.csv,2010,94.3%,5.7%
6059,The Last Five Years,292092,145427,146665,2015.csv,2015,49.8%,50.2%
6060,Dreams of a Life,291898,8405,283493,2011.csv,2011,2.9%,97.1%
6061,The Man in 3B,291513,291513,0,2015.csv,2015,100%,-
6062,Waste Land,291307,187716,103591,2010.csv,2010,64.4%,35.6%
6063,Big Bad Wolves,291239,33232,258007,2014.csv,2014,11.4%,88.6%
6064,Imaginary Heroes,291118,228767,62351,2004.csv,2004,78.6%,21.4%
6065,Power and Terror: Noam Chomsky in Our Times,290767,290767,0,2002.csv,2002,100%,-
6066,More Than Funny,290498,290498,0,2018.csv,2018,100%,-
6067,Illégal,290108,651,289457,2010.csv,2010,0.2%,99.8%
6068,Jimmy Vestvood: Amerikan Hero,290080,230069,60011,2016.csv,2016,79.3%,20.7%
6069,Best F(r)iends: Volume 1,290064,252410,37654,2018.csv,2018,87%,13%
6070,Scratch,289885,289885,0,2002.csv,2002,100%,-
6071,The Zoya Factor,289631,128831,160800,2019.csv,2019,44.5%,55.5%
6072,Best Night Ever,289511,0,289511,2014.csv,2014,-,100%
6073,The Silence of Others,289455,67986,221469,2018.csv,2018,23.5%,76.5%
6074,Welcome to New York,288837,0,288837,2014.csv,2014,-,100%
6075,Antarctica: A Year on Ice,288757,288757,0,2014.csv,2014,100%,-
6076,Above and Beyond,288751,288751,0,2015.csv,2015,100%,-
6077,"A White, White Day",288708,0,288708,2019.csv,2019,-,100%
6078,The Last of Robin Hood,288545,288545,0,2014.csv,2014,100%,-
6079,Saga of Tanya the Evil - The Movie,288460,288460,0,2019.csv,2019,100%,-
6080,Last Train Home,288328,288328,0,2010.csv,2010,100%,-
6081,American Pimp,287724,287724,0,2000.csv,2000,100%,-
6082,Countdown to Zero,287711,272040,15671,2010.csv,2010,94.6%,5.4%
6083,Generation Wealth,287709,237709,50000,2018.csv,2018,82.6%,17.4%
6084,Skate Kitchen,287307,236799,50508,2018.csv,2018,82.4%,17.6%
6085,Post Mortem,286702,9750,276952,2010.csv,2010,3.4%,96.6%
6086,The Interrupters,286457,282448,4009,2011.csv,2011,98.6%,1.4%
6087,Time Freak,285416,10003,275413,2018.csv,2018,3.5%,96.5%
6088,Notre musique,285354,139922,145432,2004.csv,2004,49%,51%
6089,But Deliver Us from Evil,285169,285169,0,2018.csv,2018,100%,-
6090,Das letzte Schweigen 2012 Re-release,284471,100214,184257,2012.csv,2012,35.2%,64.8%
6091,Khalid: Free Spirit,284229,284229,0,2019.csv,2019,100%,-
6092,South of the Border,284214,198600,85614,2010.csv,2010,69.9%,30.1%
6093,The Anonymous People,284147,284147,0,2013.csv,2013,100%,-
6094,The Kindergarten Teacher,284065,36190,247875,2014.csv,2014,12.7%,87.3%
6095,George Washington,283846,247406,36440,2000.csv,2000,87.2%,12.8%
6096,The Heart of Me,282519,196067,86452,2003.csv,2003,69.4%,30.6%
6097,Disney's Newsies: The Broadway Musical! 2018 Re-release,282429,282429,0,2018.csv,2018,100%,-
6098,Tumbledown,282083,135026,147057,2016.csv,2016,47.9%,52.1%
6099,Ho Mann Jahaan,281926,208611,73315,2016.csv,2016,74%,26%
6100,Green Dragon,281803,281803,0,2002.csv,2002,100%,-
6101,Mike Wallace Is Here,281245,281245,0,2019.csv,2019,100%,-
6102,Zus & Zo,281219,49468,231751,2002.csv,2002,17.6%,82.4%
6103,"If I Want to Whistle, I Whistle",280892,12135,268757,2010.csv,2010,4.3%,95.7%
6104,The Body,280777,36849,243928,2001.csv,2001,13.1%,86.9%
6105,Octaman,280710,280710,0,2019.csv,2019,100%,-
6106,I Do... Until I Don't,280668,280668,0,2017.csv,2017,100%,-
6107,Who Is Cletis Tout?,280458,252706,27752,2002.csv,2002,90.1%,9.9%
6108,The Battle of Shaker Heights,280351,280351,0,2003.csv,2003,100%,-
6109,Forrest Gump 2019 Re-release,280266,203088,77178,2019.csv,2019,72.5%,27.5%
6110,The Black Power Mixtape 1967-1975,280025,273749,6276,2011.csv,2011,97.8%,2.2%
6111,Namaste England,279934,104156,175778,2018.csv,2018,37.2%,62.8%
6112,Wonders of the Sea,279415,100780,178635,2018.csv,2018,36.1%,63.9%
6113,Havenhurst,279372,0,279372,2016.csv,2016,-,100%
6114,Christmas in the Clouds,279225,279225,0,2005.csv,2005,100%,-
6115,"Lovely, Still",279170,127564,151606,2010.csv,2010,45.7%,54.3%
6116,The Five Obstructions,279032,165845,113187,2004.csv,2004,59.4%,40.6%
6117,"Lou Andreas-Salomé, The Audacity to be Free",278982,12875,266107,2017.csv,2017,4.6%,95.4%
6118,Smiling Fish & Goat on Fire,278492,278492,0,2000.csv,2000,100%,-
6119,10 Years,278336,203373,74963,2012.csv,2012,73.1%,26.9%
6120,The Summit,277651,243550,34101,2013.csv,2013,87.7%,12.3%
6121,Solas,277596,277596,0,2000.csv,2000,100%,-
6122,Science Fair,277338,276195,1143,2018.csv,2018,99.6%,0.4%
6123,See You Soon,277126,0,277126,2019.csv,2019,-,100%
6124,True Grit 2019 Re-release,276418,276418,0,2019.csv,2019,100%,-
6125,Seven Samurai 2002 Re-release,275965,271841,4124,2002.csv,2002,98.5%,1.5%
6126,Piñero,275171,275171,0,2001.csv,2001,100%,-
6127,Life After Beth,274717,88273,186444,2014.csv,2014,32.1%,67.9%
6128,Hey Ram,274675,274675,0,2000.csv,2000,100%,-
6129,Lovely Molly,274480,18464,256016,2012.csv,2012,6.7%,93.3%
6130,The King,273601,259291,14310,2018.csv,2018,94.8%,5.2%
6131,Ek Ajnabee,273364,213143,60221,2005.csv,2005,78%,22%
6132,P.S.,273023,180503,92520,2004.csv,2004,66.1%,33.9%
6133,Slayer: The Repentless Killogy,272874,268727,4147,2019.csv,2019,98.5%,1.5%
6134,Chavela,272842,148666,124176,2017.csv,2017,54.5%,45.5%
6135,Stander,272791,31651,241140,2003.csv,2003,11.6%,88.4%
6136,Black Death,272445,22554,249891,2010.csv,2010,8.3%,91.7%
6137,One Child Nation,271841,270128,1713,2019.csv,2019,99.4%,0.6%
6138,Come Out and Play,271735,2638,269097,2013.csv,2013,1%,99%
6139,Aloft,270971,53086,217885,2015.csv,2015,19.6%,80.4%
6140,Rishtey,270929,119537,151392,2002.csv,2002,44.1%,55.9%
6141,Deep in the Woods,270890,56119,214771,2000.csv,2000,20.7%,79.3%
6142,Waking the Dead,270745,270745,0,2000.csv,2000,100%,-
6143,The Canyons,270185,56825,213360,2013.csv,2013,21%,79%
6144,This Old Cub,270014,270014,0,2004.csv,2004,100%,-
6145,Exposed,269915,0,269915,2016.csv,2016,-,100%
6146,Stalker,269881,269881,0,2017.csv,2017,100%,-
6147,Shirin Farhad Ki Toh Nikal Padi,269845,155758,114087,2012.csv,2012,57.7%,42.3%
6148,The Loneliest Planet,268933,129579,139354,2012.csv,2012,48.2%,51.8%
6149,The World Before Your Feet,268644,268644,0,2018.csv,2018,100%,-
6150,Psycho Beach Party,268117,268117,0,2000.csv,2000,100%,-
6151,Meri Pyaari Bindu,268067,0,268067,2017.csv,2017,-,100%
6152,The Carer,267995,6208,261787,2016.csv,2016,2.3%,97.7%
6153,Conan O'Brien Can't Stop,267965,267965,0,2011.csv,2011,100%,-
6154,Falcon Rising,267476,11774,255702,2014.csv,2014,4.4%,95.6%
6155,Gilles' Wife,267402,32799,234603,2004.csv,2004,12.3%,87.7%
6156,Munger Road,266689,266689,0,2011.csv,2011,100%,-
6157,Luzia: Cirque du Soleil in Cinema,265673,265673,0,2019.csv,2019,100%,-
6158,Félicité,265495,12433,253062,2017.csv,2017,4.7%,95.3%
6159,Out of Liberty,265279,265279,0,2019.csv,2019,100%,-
6160,Asbury Park: Riot Redemption Rock 'n Roll,264983,167684,97299,2019.csv,2019,63.3%,36.7%
6161,Doctor Who,264629,264629,0,2018.csv,2018,100%,-
6162,Riding the Bullet,264505,134711,129794,2004.csv,2004,50.9%,49.1%
6163,Beautiful People,264292,264292,0,2000.csv,2000,100%,-
6164,Phil Ochs: There But for Fortune,263723,263723,0,2011.csv,2011,100%,-
6165,The Producers 2018 Re-release,263277,216807,46470,2018.csv,2018,82.3%,17.7%
6166,Life and Debt,263107,263107,0,2001.csv,2001,100%,-
6167,My Date with Drew,262770,181041,81729,2005.csv,2005,68.9%,31.1%
6168,Raja,262643,13000,249643,2003.csv,2003,4.9%,95.1%
6169,Grand départ,262412,677,261735,2013.csv,2013,0.3%,99.7%
6170,Augustine,262390,107352,155038,2013.csv,2013,40.9%,59.1%
6171,The Final Year,262286,191900,70386,2018.csv,2018,73.2%,26.8%
6172,Minimalism: A Documentary About the Important Things,261865,261865,0,2016.csv,2016,100%,-
6173,Any Day Now,261747,201395,60352,2012.csv,2012,76.9%,23.1%
6174,Half Girlfriend,261597,0,261597,2017.csv,2017,-,100%
6175,Circuit,261155,235087,26068,2002.csv,2002,90%,10%
6176,Eating You Alive,260534,260534,0,2018.csv,2018,100%,-
6177,Stone Reader,260523,260523,0,2003.csv,2003,100%,-
6178,Her Smell,260481,255599,4882,2019.csv,2019,98.1%,1.9%
6179,Star Raiders: The Adventures of Saber Raine,260234,260234,0,2019.csv,2019,100%,-
6180,The Wind Will Carry Us,259510,259510,0,2000.csv,2000,100%,-
6181,James' Journey to Jerusalem,259026,64967,194059,2004.csv,2004,25.1%,74.9%
6182,The Cave,258921,62625,196296,2019.csv,2019,24.2%,75.8%
6183,Malevolence,258782,127287,131495,2004.csv,2004,49.2%,50.8%
6184,The Unspoken,258760,0,258760,2016.csv,2016,-,100%
6185,Across the Universe 2018 Re-release,258618,258618,0,2018.csv,2018,100%,-
6186,What Time Is It There?,258592,195760,62832,2001.csv,2001,75.7%,24.3%
6187,Big 2018 Re-release,258507,258507,0,2018.csv,2018,100%,-
6188,The Music Never Stopped,258223,258223,0,2011.csv,2011,100%,-
6189,Mayor of the Sunset Strip,257315,257315,0,2004.csv,2004,100%,-
6190,Mysteries of Lisbon,257065,110507,146558,2010.csv,2010,43%,57%
6191,Spiders 3D,257019,0,257019,2013.csv,2013,-,100%
6192,Raja Natwarlal,256978,131105,125873,2014.csv,2014,51%,49%
6193,Helicopter Eela,256952,71971,184981,2018.csv,2018,28%,72%
6194,Alive Inside,256682,256682,0,2014.csv,2014,100%,-
6195,Jean-Michel Basquiat: The Radiant Child,256242,256242,0,2010.csv,2010,100%,-
6196,Greendale,255947,255947,0,2004.csv,2004,100%,-
6197,Officer Down,255080,1463,253617,2013.csv,2013,0.6%,99.4%
6198,Sex with Strangers,254852,254852,0,2002.csv,2002,100%,-
6199,Gerry,254683,254683,0,2003.csv,2003,100%,-
6200,Dean,254536,254536,0,2017.csv,2017,100%,-
6201,The Robber,254489,83451,171038,2010.csv,2010,32.8%,67.2%
6202,Maelstrom,254380,254380,0,2000.csv,2000,100%,-
6203,Civil Brand,254293,254293,0,2003.csv,2003,100%,-
6204,Fall in Love Like a Star 2015 Re-release,253785,212508,41277,2015.csv,2015,83.7%,16.3%
6205,Battle in Heaven,253751,70899,182852,2005.csv,2005,27.9%,72.1%
6206,Mistaken for Strangers,253285,138991,114294,2014.csv,2014,54.9%,45.1%
6207,Battlefield America,252805,172000,80805,2012.csv,2012,68%,32%
6208,I Got the Hook Up 2,252293,252293,0,2019.csv,2019,100%,-
6209,The Human Centipede (First Sequence),252207,181467,70740,2010.csv,2010,72%,28%
6210,Caterpillar,251922,4157,247765,2010.csv,2010,1.7%,98.3%
6211,Canal Street,251917,251917,0,2019.csv,2019,100%,-
6212,Gook,251541,250130,1411,2017.csv,2017,99.4%,0.6%
6213,Dominion,251495,251495,0,2005.csv,2005,100%,-
6214,Happenstance,251444,251444,0,2001.csv,2001,100%,-
6215,Games of Love and Chance 2005 Re-release,249616,8085,241531,2005.csv,2005,3.2%,96.8%
6216,Gay Sex in the 70s,249565,249565,0,2005.csv,2005,100%,-
6217,May,249300,150277,99023,2003.csv,2003,60.3%,39.7%
6218,Skins,249204,249204,0,2002.csv,2002,100%,-
6219,The Twilight Zone: A 60th Anniversary Celebration,248514,248514,0,2019.csv,2019,100%,-
6220,Band Aid,248370,248370,0,2017.csv,2017,100%,-
6221,The Attacks of 26/11,248346,248346,0,2013.csv,2013,100%,-
6222,Testosterone,248128,185078,63050,2004.csv,2004,74.6%,25.4%
6223,Wild Oats,247949,40598,207351,2016.csv,2016,16.4%,83.6%
6224,Doctor Who: The End of Time: Part One,247798,247798,0,2019.csv,2019,100%,-
6225,Marcel Proust's Time Regained,247728,247728,0,2000.csv,2000,100%,-
6226,Charlotte Sometimes,247554,150445,97109,2002.csv,2002,60.8%,39.2%
6227,Lilting,247377,27054,220323,2014.csv,2014,10.9%,89.1%
6228,The Galapagos Affair: Satan Came to Eden,247159,247159,0,2014.csv,2014,100%,-
6229,My Dog Tulip,246574,246574,0,2010.csv,2010,100%,-
6230,The Notebook 2013 Re-release,246557,66559,179998,2013.csv,2013,27%,73%
6231,The Animation Show 2005 Re-release,246520,246520,0,2005.csv,2005,100%,-
6232,The Love Witch,246218,228894,17324,2016.csv,2016,93%,7%
6233,Hot Summer Nights,246133,0,246133,2018.csv,2018,-,100%
6234,Watermarks,246094,246094,0,2005.csv,2005,100%,-
6235,"Tuesday, After Christmas",245833,27813,218020,2010.csv,2010,11.3%,88.7%
6236,Harry Potter and the Chamber of Secrets 2018 Re-release,245501,245501,0,2018.csv,2018,100%,-
6237,American Woman,245416,236637,8779,2019.csv,2019,96.4%,3.6%
6238,The Fireflies Are Gone,245006,245006,0,2018.csv,2018,100%,-
6239,The Waiting Room,244951,244951,0,2012.csv,2012,100%,-
6240,This Is Spinal Tap 2000 Re-release,244557,244557,0,2000.csv,2000,100%,-
6241,Time and Tide,243978,10770,233208,2001.csv,2001,4.4%,95.6%
6242,Term Life,243793,21256,222537,2016.csv,2016,8.7%,91.3%
6243,My Uncle Rafael,243616,243616,0,2012.csv,2012,100%,-
6244,Rangeelay,243246,148418,94828,2013.csv,2013,61%,39%
6245,Santitos,243000,243000,0,2000.csv,2000,100%,-
6246,Out of Blue,242847,18779,224068,2019.csv,2019,7.7%,92.3%
6247,Audition,242759,131296,111463,2001.csv,2001,54.1%,45.9%
6248,My Perestroika,242707,242707,0,2011.csv,2011,100%,-
6249,Tevar,242453,236002,6451,2015.csv,2015,97.3%,2.7%
6250,Play the Flute,241251,241251,0,2019.csv,2019,100%,-
6251,Brotherhood,240887,8979,231908,2010.csv,2010,3.7%,96.3%
6252,Darshan,240819,66032,174787,2005.csv,2005,27.4%,72.6%
6253,Road to Ninja: Naruto the Movie 2014 Re-release,240687,43171,197516,2014.csv,2014,17.9%,82.1%
6254,Boulevard,240450,126150,114300,2015.csv,2015,52.5%,47.5%
6255,Carter High,240214,240214,0,2015.csv,2015,100%,-
6256,ABCD (Any Body Can Dance),240194,222098,18096,2013.csv,2013,92.5%,7.5%
6257,Of Horses and Men,239969,11894,228075,2013.csv,2013,5%,95%
6258,Dark River,239182,7714,231468,2018.csv,2018,3.2%,96.8%
6259,Uncovered: The War on Iraq,238924,238924,0,2004.csv,2004,100%,-
6260,Nina's Tragedies,238831,238831,0,2005.csv,2005,100%,-
6261,311 Enlarged to Show Detail 3,238791,238791,0,2019.csv,2019,100%,-
6262,La bûche,238754,238754,0,2000.csv,2000,100%,-
6263,Crown Heights,238558,238558,0,2017.csv,2017,100%,-
6264,The Independent,238431,238431,0,2001.csv,2001,100%,-
6265,RWBY: Argus Limited,238379,238379,0,2018.csv,2018,100%,-
6266,"Ram Dass, Fierce Grace",238260,238260,0,2002.csv,2002,100%,-
6267,Red Obsession,238223,13199,225024,2013.csv,2013,5.5%,94.5%
6268,American Satan,237708,237708,0,2017.csv,2017,100%,-
6269,Alien Intrusion: Unmasking a Deception,237411,237411,0,2018.csv,2018,100%,-
6270,Shuddh Desi Romance,237249,0,237249,2013.csv,2013,-,100%
6271,New York Doll,237136,219672,17464,2005.csv,2005,92.6%,7.4%
6272,Middle of Nowhere,236806,236806,0,2012.csv,2012,100%,-
6273,Chopper,236185,236185,0,2001.csv,2001,100%,-
6274,The Far Side of the Moon,235926,235926,0,2003.csv,2003,100%,-
6275,India's Most Wanted,235351,176858,58493,2019.csv,2019,75.1%,24.9%
6276,The Exorcist Extended Director's Cut,235134,235134,0,2010.csv,2010,100%,-
6277,Diamantino,235041,70088,164953,2018.csv,2018,29.8%,70.2%
6278,Art and Craft,235037,235037,0,2014.csv,2014,100%,-
6279,Blind Eyes Opened,234505,234505,0,2020.csv,2020,100%,-
6280,After the Ball,234417,161820,72597,2015.csv,2015,69%,31%
6281,Swimming,234287,234287,0,2002.csv,2002,100%,-
6282,Little Shop of Horrors 2017 Re-release,233865,233865,0,2017.csv,2017,100%,-
6283,Varda by Agnès,233809,160765,73044,2019.csv,2019,68.8%,31.2%
6284,Superman 2018 Re-release,233585,233585,0,2018.csv,2018,100%,-
6285,Premier Boxing Champions: PBC on FOX: Spence vs. Porter,232973,232973,0,2019.csv,2019,100%,-
6286,Lost and Found in Armenia,232857,122305,110552,2012.csv,2012,52.5%,47.5%
6287,Down and Derby,231609,231609,0,2005.csv,2005,100%,-
6288,Bishôjo senshi Sailor Moon Super S Special,231434,231434,0,2018.csv,2018,100%,-
6289,The World,231383,64123,167260,2005.csv,2005,27.7%,72.3%
6290,A Place at the Table,231378,231378,0,2013.csv,2013,100%,-
6291,The Great Role,231162,11419,219743,2004.csv,2004,4.9%,95.1%
6292,Les destinées,230900,230900,0,2002.csv,2002,100%,-
6293,DAZN Boxing: Canelo Alvarez vs. Daniel Jacobs,230703,230703,0,2019.csv,2019,100%,-
6294,"Life, Above All",230529,134461,96068,2011.csv,2011,58.3%,41.7%
6295,Chakravyuh,230136,151778,78358,2012.csv,2012,66%,34%
6296,"Belle and Sebastian, Friends for Life 2018 Re-release",229983,105890,124093,2018.csv,2018,46%,54%
6297,Wrecked,229532,8020,221512,2011.csv,2011,3.5%,96.5%
6298,Ophelia,229405,50722,178683,2019.csv,2019,22.1%,77.9%
6299,Luv Shuv Tey Chicken Khurana,229136,143507,85629,2012.csv,2012,62.6%,37.4%
6300,Dig!,228828,127067,101761,2004.csv,2004,55.5%,44.5%
6301,Fast Food Fast Women,228787,17131,211656,2001.csv,2001,7.5%,92.5%
6302,Murder 2,228501,59000,169501,2011.csv,2011,25.8%,74.2%
6303,City of Ghosts,228225,128015,100210,2017.csv,2017,56.1%,43.9%
6304,Jeremiah Tower: The Last Magnificent,228153,228153,0,2017.csv,2017,100%,-
6305,InAPPropriate Comedy,228004,228004,0,2013.csv,2013,100%,-
6306,Like Water,227332,0,227332,2012.csv,2012,-,100%
6307,Guiana 1838,227241,227241,0,2004.csv,2004,100%,-
6308,Studio 54,227062,199767,27295,2018.csv,2018,88%,12%
6309,This So-Called Disaster: Sam Shepard Directs the Late Henry Moss,226658,226658,0,2004.csv,2004,100%,-
6310,Mine 9,226421,226421,0,2019.csv,2019,100%,-
6311,The Agronomist,226189,226189,0,2004.csv,2004,100%,-
6312,Blue Gate Crossing,226067,6242,219825,2003.csv,2003,2.8%,97.2%
6313,Rumble: The Indians Who Rocked The World,226006,226006,0,2017.csv,2017,100%,-
6314,The Keeper: The Legend of Omar Khayyam,225863,225863,0,2005.csv,2005,100%,-
6315,The Ballad of Ramblin' Jack,225682,225682,0,2000.csv,2000,100%,-
6316,Dr. Cabbie,225490,225490,0,2014.csv,2014,100%,-
6317,The Beauty Academy of Kabul,225448,225448,0,2005.csv,2005,100%,-
6318,Murderous Maids,225390,225390,0,2002.csv,2002,100%,-
6319,Millennium Actress 2019 Re-release,225250,225250,0,2019.csv,2019,100%,-
6320,The Black Waters of Echo's Pond,224409,224409,0,2010.csv,2010,100%,-
6321,Funny Girl 2001 Re-release,224263,223306,957,2001.csv,2001,99.6%,0.4%
6322,Experimenter,224145,155575,68570,2015.csv,2015,69.4%,30.6%
6323,Tampopo,224097,224097,0,2016.csv,2016,100%,-
6324,Extra Ordinary,223898,164346,59552,2019.csv,2019,73.4%,26.6%
6325,Premier Boxing Champions: PBC on FOX PPV: Pacquiao vs. Thurman,223858,223858,0,2019.csv,2019,100%,-
6326,Crystal Fairy & the Magical Cactus,223821,202370,21451,2013.csv,2013,90.4%,9.6%
6327,BuyBust,223720,178471,45249,2018.csv,2018,79.8%,20.2%
6328,Tim and Eric's Billion Dollar Movie,223580,201436,22144,2012.csv,2012,90.1%,9.9%
6329,Love Liza,223426,213137,10289,2002.csv,2002,95.4%,4.6%
6330,Take Every Wave: The Life of Laird Hamilton,223301,176076,47225,2017.csv,2017,78.9%,21.1%
6331,Never Surrender: A Galaxy Quest Documentary,222971,222971,0,2019.csv,2019,100%,-
6332,Spirit of the Game,222565,222565,0,2016.csv,2016,100%,-
6333,10.000 Km,222530,12423,210107,2014.csv,2014,5.6%,94.4%
6334,Secret Things,222396,105090,117306,2002.csv,2002,47.3%,52.7%
6335,Bus 174,222247,217201,5046,2003.csv,2003,97.7%,2.3%
6336,High School,221590,139034,82556,2012.csv,2012,62.7%,37.3%
6337,Neil Young Journeys,221082,215026,6056,2012.csv,2012,97.3%,2.7%
6338,Phantom Boy,221016,34362,186654,2015.csv,2015,15.5%,84.5%
6339,Little Pink House,220948,220948,0,2018.csv,2018,100%,-
6340,Chance Pe Dance,220619,168643,51976,2010.csv,2010,76.4%,23.6%
6341,Mela,220524,220524,0,2000.csv,2000,100%,-
6342,The Cockettes,220165,220165,0,2002.csv,2002,100%,-
6343,Supermensch: The Legend of Shep Gordon,220065,213064,7001,2014.csv,2014,96.8%,3.2%
6344,Lower City,219814,130794,89020,2005.csv,2005,59.5%,40.5%
6345,The Metropolitan Opera HD Live: Puccini: Turandot,219619,172627,46992,2018.csv,2018,78.6%,21.4%
6346,Brooklyn Castle,219407,219407,0,2012.csv,2012,100%,-
6347,Fragments of Truth,219342,219342,0,2018.csv,2018,100%,-
6348,Club Life,219229,4444,214785,2015.csv,2015,2%,98%
6349,The House I Live In,219159,210752,8407,2012.csv,2012,96.2%,3.8%
6350,Harry Potter and the Prisoner of Azkaban 2018 Re-release,218774,218774,0,2018.csv,2018,100%,-
6351,California Typewriter,218563,218563,0,2017.csv,2017,100%,-
6352,Dark Money,217932,217932,0,2018.csv,2018,100%,-
6353,Getting Grace,217812,217812,0,2018.csv,2018,100%,-
6354,Beautiful Creatures,217679,55835,161844,2001.csv,2001,25.7%,74.3%
6355,Jane's Journey,217615,27253,190362,2010.csv,2010,12.5%,87.5%
6356,Complete Unknown,217473,191761,25712,2016.csv,2016,88.2%,11.8%
6357,Ratcatcher,217244,217244,0,2000.csv,2000,100%,-
6358,Two Men Went to War,217151,150208,66943,2003.csv,2003,69.2%,30.8%
6359,Beijing Bicycle,215854,66131,149723,2001.csv,2001,30.6%,69.4%
6360,The Karate Kid 2019 Re-release,215447,215447,0,2019.csv,2019,100%,-
6361,The Treasure of the Sierra Madre,215295,215295,0,2018.csv,2018,100%,-
6362,The Tribe,215034,150564,64470,2015.csv,2015,70%,30%
6363,Risk,214669,200219,14450,2017.csv,2017,93.3%,6.7%
6364,2001: A Space Odyssey 2013 Re-release,214618,214618,0,2013.csv,2013,100%,-
6365,Hamlet 2019 Re-release,214578,214578,0,2019.csv,2019,100%,-
6366,The Pervert's Guide to Ideology,214313,67966,146347,2013.csv,2013,31.7%,68.3%
6367,Ingrid Bergman: In Her Own Words,214014,138148,75866,2015.csv,2015,64.6%,35.4%
6368,Marjorie Prime,213858,180608,33250,2017.csv,2017,84.5%,15.5%
6369,The Château,213598,202272,11326,2002.csv,2002,94.7%,5.3%
6370,Thaandavam,213476,213476,0,2012.csv,2012,100%,-
6371,The Wound,213043,30678,182365,2017.csv,2017,14.4%,85.6%
6372,The Delicate Art of Parking,213008,213008,0,2004.csv,2004,100%,-
6373,The Afflicted,212940,212940,0,2011.csv,2011,100%,-
6374,Chocolate City,212662,212662,0,2015.csv,2015,100%,-
6375,Young and Wild,212624,5514,207110,2012.csv,2012,2.6%,97.4%
6376,Big Sonia,212471,212471,0,2017.csv,2017,100%,-
6377,Fatima,212228,50105,162123,2016.csv,2016,23.6%,76.4%
6378,Donnie Darko 2016 Re-release,212034,207971,4063,2016.csv,2016,98.1%,1.9%
6379,Somewhere Between,210975,210975,0,2012.csv,2012,100%,-
6380,La soga,210625,210625,0,2010.csv,2010,100%,-
6381,A Glimpse Inside the Mind of Charles Swan III,210565,45350,165215,2013.csv,2013,21.5%,78.5%
6382,Tigers Are Not Afraid 2019 Re-release,210138,175559,34579,2019.csv,2019,83.5%,16.5%
6383,Beware of Mr. Baker,210123,116476,93647,2012.csv,2012,55.4%,44.6%
6384,"Faith, Hope & Love",210091,210091,0,2019.csv,2019,100%,-
6385,House,209765,209765,0,2010.csv,2010,100%,-
6386,The Death of Louis XIV,209715,43635,166080,2016.csv,2016,20.8%,79.2%
6387,Rob the Mob,209613,208693,920,2014.csv,2014,99.6%,0.4%
6388,SEED: The Untold Story,209580,207825,1755,2016.csv,2016,99.2%,0.8%
6389,Kathy Griffin: A Hell of a Story,208907,208907,0,2019.csv,2019,100%,-
6390,Casablanca 2013 Re-release,208608,208608,0,2013.csv,2013,100%,-
6391,Boys Life 3,208538,208538,0,2000.csv,2000,100%,-
6392,Agent Mr. Chan,208351,208351,0,2018.csv,2018,100%,-
6393,The Right Kind of Wrong,208105,2098,206007,2014.csv,2014,1%,99%
6394,The Dating Project,208100,208100,0,2018.csv,2018,100%,-
6395,Batman 2019 Re-release,207901,159419,48482,2019.csv,2019,76.7%,23.3%
6396,Under the Electric Sky,207584,207584,0,2014.csv,2014,100%,-
6397,Heading Home: The Tale of Team Israel,207533,207533,0,2018.csv,2018,100%,-
6398,Sweetgrass,207473,207473,0,2010.csv,2010,100%,-
6399,Advanced Style,207231,87879,119352,2014.csv,2014,42.4%,57.6%
6400,Ek Thi Daayan,206279,112135,94144,2013.csv,2013,54.4%,45.6%
6401,The Desert Bride,205350,30110,175240,2017.csv,2017,14.7%,85.3%
6402,The Tic Code,205003,205003,0,2000.csv,2000,100%,-
6403,The Untold Story of Emmett Louis Till,204956,204956,0,2005.csv,2005,100%,-
6404,Sicilian Ghost Story,204892,15285,189607,2017.csv,2017,7.5%,92.5%
6405,The Iron Orchard,204881,204881,0,2019.csv,2019,100%,-
6406,Working Woman,204727,64048,140679,2019.csv,2019,31.3%,68.7%
6407,Hesburgh,204709,204709,0,2019.csv,2019,100%,-
6408,Don't Call Me Son,204583,11678,192905,2016.csv,2016,5.7%,94.3%
6409,Pop Aye,204464,77976,126488,2017.csv,2017,38.1%,61.9%
6410,Touchback,204232,204232,0,2012.csv,2012,100%,-
6411,Postmen in the Mountains,203975,203975,0,2003.csv,2003,100%,-
6412,The Home Teachers,203917,203917,0,2004.csv,2004,100%,-
6413,Bulandi,203548,203548,0,2000.csv,2000,100%,-
6414,States of Grace,203144,203144,0,2005.csv,2005,100%,-
6415,Charlie's Country,202966,42937,160029,2014.csv,2014,21.2%,78.8%
6416,Keep the Change,202788,202788,0,2018.csv,2018,100%,-
6417,"Filth to Ashes, Flesh to Dust",202531,202531,0,2011.csv,2011,100%,-
6418,The Bolshoi Ballet: Live From Moscow - Coppélia,202217,202217,0,2018.csv,2018,100%,-
6419,"Hieronymus Bosch, Touched by the Devil",201907,172533,29374,2016.csv,2016,85.5%,14.5%
6420,The Bad Batch,201890,180851,21039,2017.csv,2017,89.6%,10.4%
6421,Blink of an Eye,201874,201874,0,2019.csv,2019,100%,-
6422,Lightning in a Bottle,201711,201711,0,2004.csv,2004,100%,-
6423,The Vertical Ray of the Sun,201247,110134,91113,2001.csv,2001,54.7%,45.3%
6424,The Snow Walker,201149,201149,0,2004.csv,2004,100%,-
6425,Independent Lens: Imelda,200992,200992,0,2004.csv,2004,100%,-
6426,Kikujiro,200920,200920,0,2000.csv,2000,100%,-
6427,Zombi Child,200909,25878,175031,2019.csv,2019,12.9%,87.1%
6428,Legendary,200393,200393,0,2010.csv,2010,100%,-
6429,Masculin Féminin,200380,200380,0,2005.csv,2005,100%,-
6430,Gemini,200340,200340,0,2018.csv,2018,100%,-
6431,White Girl,200242,200242,0,2016.csv,2016,100%,-
6432,No Place on Earth,200238,200238,0,2013.csv,2013,100%,-
6433,9/11,200229,170000,30229,2017.csv,2017,84.9%,15.1%
6434,Or (My Treasure),200175,29194,170981,2004.csv,2004,14.6%,85.4%
6435,Listen Up Philip,200126,200126,0,2014.csv,2014,100%,-
6436,Cutie and the Boxer,200036,200036,0,2013.csv,2013,100%,-
6437,Rebel Without a Cause 2018 Re-release,199963,199963,0,2018.csv,2018,100%,-
6438,The Fallen Idol 2016 Re-release,199619,199619,0,2016.csv,2016,100%,-
6439,October Baby,199442,199442,0,2011.csv,2011,100%,-
6440,Chal Mere Bhai,199227,199227,0,2000.csv,2000,100%,-
6441,Ex Libris: New York Public Library,198239,158192,40047,2017.csv,2017,79.8%,20.2%
6442,A Summer's Tale,198126,198126,0,2014.csv,2014,100%,-
6443,Whores' Glory,197932,31420,166512,2011.csv,2011,15.9%,84.1%
6444,Pusher,197857,0,197857,2012.csv,2012,-,100%
6445,Madeline's Madeline,197309,185576,11733,2018.csv,2018,94.1%,5.9%
6446,Sky Blue,197221,74663,122558,2004.csv,2004,37.9%,62.1%
6447,Have It All -The Movie,197142,197142,0,2018.csv,2018,100%,-
6448,Little Joe,196960,23862,173098,2019.csv,2019,12.1%,87.9%
6449,Japón,196702,21900,174802,2003.csv,2003,11.1%,88.9%
6450,Buñuel in the Labyrinth of the Turtles,196456,36205,160251,2019.csv,2019,18.4%,81.6%
6451,Mom,195701,0,195701,2017.csv,2017,-,100%
6452,Boom for Real: The Late Teenage Years of Jean-Michel Basquiat,195517,166616,28901,2018.csv,2018,85.2%,14.8%
6453,The Princess and the Pea,195358,0,195358,2005.csv,2005,-,100%
6454,The Divine Order,195081,76277,118804,2017.csv,2017,39.1%,60.9%
6455,Free Angela and All Political Prisoners,195005,194102,903,2013.csv,2013,99.5%,0.5%
6456,Family,194601,194601,0,2019.csv,2019,100%,-
6457,A Screaming Man,193981,9862,184119,2010.csv,2010,5.1%,94.9%
6458,Alila,193385,50961,142424,2003.csv,2003,26.4%,73.6%
6459,Mr. Klein,193028,193028,0,2019.csv,2019,100%,-
6460,Client 9: The Rise and Fall of Eliot Spitzer,192870,189416,3454,2010.csv,2010,98.2%,1.8%
6461,November,192186,192186,0,2005.csv,2005,100%,-
6462,Claire's Camera,191980,83418,108562,2018.csv,2018,43.5%,56.5%
6463,Past Life,191678,180099,11579,2017.csv,2017,94%,6%
6464,Diamond Men,191221,191221,0,2001.csv,2001,100%,-
6465,Chalo Dilli,191185,94300,96885,2011.csv,2011,49.3%,50.7%
6466,The Romantics,191019,106524,84495,2010.csv,2010,55.8%,44.2%
6467,Digimon Adventure tri. Part 1: Reunion,190581,190581,0,2016.csv,2016,100%,-
6468,One Week,190441,190441,0,2001.csv,2001,100%,-
6469,Code Black,190229,190229,0,2014.csv,2014,100%,-
6470,The Divine Plan,190031,190031,0,2019.csv,2019,100%,-
6471,Java Heat,189739,1061,188678,2013.csv,2013,0.6%,99.4%
6472,Munna Michael,189105,99629,89476,2017.csv,2017,52.7%,47.3%
6473,Nick Saban: Gamechanger,189000,189000,0,2010.csv,2010,100%,-
6474,Harry Potter and the Goblet of Fire 2018 Re-release,188716,188716,0,2018.csv,2018,100%,-
6475,Days of Being Wild,188630,146310,42320,2004.csv,2004,77.6%,22.4%
6476,Lost Boys of Sudan,188467,188467,0,2003.csv,2003,100%,-
6477,Leap Year,188242,12979,175263,2010.csv,2010,6.9%,93.1%
6478,The Bolshoi Ballet: Live From Moscow - Don Quixote,187946,187946,0,2018.csv,2018,100%,-
6479,Owaranai hito: Miyazaki Hayao,187320,187320,0,2018.csv,2018,100%,-
6480,Calle 54,187308,187308,0,2000.csv,2000,100%,-
6481,The Last Days on Mars,187191,24084,163107,2013.csv,2013,12.9%,87.1%
6482,Stoned,187160,38922,148238,2005.csv,2005,20.8%,79.2%
6483,The Big Tease,187152,187152,0,2000.csv,2000,100%,-
6484,In the Fog,186838,11894,174944,2013.csv,2013,6.4%,93.6%
6485,Good for Nothing,186119,0,186119,2012.csv,2012,-,100%
6486,Twiceland,186078,52874,133204,2018.csv,2018,28.4%,71.6%
6487,Salt of This Sea 2010 Re-release,186045,11662,174383,2010.csv,2010,6.3%,93.7%
6488,In the Basement,186036,3643,182393,2014.csv,2014,2%,98%
6489,National Theatre Live: King Lear,185305,185305,0,2018.csv,2018,100%,-
6490,The Duke of Burgundy,185147,64521,120626,2015.csv,2015,34.8%,65.2%
6491,Cobra Kai Premiere Event feat. The Karate Kid,185082,185082,0,2018.csv,2018,100%,-
6492,Amigo,184705,184705,0,2011.csv,2011,100%,-
6493,To Dust,184495,184495,0,2019.csv,2019,100%,-
6494,Vatel,184301,51080,133221,2000.csv,2000,27.7%,72.3%
6495,The River and the Wall,183602,183602,0,2019.csv,2019,100%,-
6496,The Hidden Fortress,183579,183579,0,2001.csv,2001,100%,-
6497,"The Man Nobody Knew: In Search of My Father, CIA Spymaster William Colby",183342,183342,0,2011.csv,2011,100%,-
6498,Lambert & Stamp,183320,183320,0,2015.csv,2015,100%,-
6499,Burnt Money,183132,183132,0,2001.csv,2001,100%,-
6500,Hellbent,183066,183066,0,2005.csv,2005,100%,-
6501,Whose Streets?,182799,182799,0,2017.csv,2017,100%,-
6502,The Masked Saint,182695,182695,0,2016.csv,2016,100%,-
6503,I Am Not A Witch,182462,50868,131594,2017.csv,2017,27.9%,72.1%
6504,Shock and Awe,182415,77980,104435,2018.csv,2018,42.7%,57.3%
6505,Harry Potter and the Deathly Hallows: Part 2 2018 Re-release,181938,181938,0,2018.csv,2018,100%,-
6506,The Baxter,181872,181872,0,2005.csv,2005,100%,-
6507,Fida,181865,98297,83568,2004.csv,2004,54%,46%
6508,Fulltime Killer,181662,23124,158538,2001.csv,2001,12.7%,87.3%
6509,Giant Little Ones,181507,181507,0,2019.csv,2019,100%,-
6510,Rafiki,181316,137968,43348,2019.csv,2019,76.1%,23.9%
6511,Winnebago Man,181039,181039,0,2010.csv,2010,100%,-
6512,1001 Grams,181030,10983,170047,2014.csv,2014,6.1%,93.9%
6513,An Honest Liar,180590,180590,0,2015.csv,2015,100%,-
6514,Fukrey,180331,125279,55052,2013.csv,2013,69.5%,30.5%
6515,Go for It!,180237,180237,0,2011.csv,2011,100%,-
6516,Lost Woods,180117,180117,0,2012.csv,2012,100%,-
6517,Chop Suey,179914,179914,0,2001.csv,2001,100%,-
6518,Lila & Eve,179807,38263,141544,2015.csv,2015,21.3%,78.7%
6519,Cherish,179751,179751,0,2002.csv,2002,100%,-
6520,Protocols of Zion,178875,178875,0,2005.csv,2005,100%,-
6521,Offender,178158,0,178158,2012.csv,2012,-,100%
6522,Walking on Water,178119,102140,75979,2019.csv,2019,57.3%,42.7%
6523,Score: A Film Music Documentary,178090,101382,76708,2017.csv,2017,56.9%,43.1%
6524,Lagaan: Once Upon a Time in India 2002 Re-release,178072,73276,104796,2002.csv,2002,41.1%,58.9%
6525,Modest Heroes,178027,178027,0,2019.csv,2019,100%,-
6526,Zaytoun,177753,42330,135423,2013.csv,2013,23.8%,76.2%
6527,Monumental: In Search of America's National Treasure,177729,177729,0,2012.csv,2012,100%,-
6528,Nostalgia for the Light,177634,163962,13672,2010.csv,2010,92.3%,7.7%
6529,Bush's Brain,177485,177485,0,2004.csv,2004,100%,-
6530,Tarkovsky At 70,177345,177345,0,2002.csv,2002,100%,-
6531,People Places Things,177338,67046,110292,2015.csv,2015,37.8%,62.2%
6532,The Warrior Queen of Jhansi,177289,177289,0,2019.csv,2019,100%,-
6533,Anita,176979,176979,0,2014.csv,2014,100%,-
6534,Bye Bye Germany,176933,73730,103203,2017.csv,2017,41.7%,58.3%
6535,Casino Jack and the United States of Money,176865,176865,0,2010.csv,2010,100%,-
6536,Touch the Sound: A Sound Journey with Evelyn Glennie,176801,176801,0,2005.csv,2005,100%,-
6537,Anchor Baby,176784,15790,160994,2010.csv,2010,8.9%,91.1%
6538,Vigilante Diaries,176777,1991,174786,2016.csv,2016,1.1%,98.9%
6539,The Sea,176401,75994,100407,2003.csv,2003,43.1%,56.9%
6540,"Iyengar: The Man, Yoga, and the Student's Journey",176387,176387,0,2019.csv,2019,100%,-
6541,Better Watch Out,176288,20369,155919,2017.csv,2017,11.6%,88.4%
6542,Girl on a Bicycle,176272,91401,84871,2013.csv,2013,51.9%,48.1%
6543,The Bolshoi Ballet: Live From Moscow - The Flames of Paris,175922,175922,0,2018.csv,2018,100%,-
6544,Afternoon Delight,175755,174496,1259,2013.csv,2013,99.3%,0.7%
6545,The Business of Fancydancing,175710,175710,0,2002.csv,2002,100%,-
6546,Butter,175706,105018,70688,2012.csv,2012,59.8%,40.2%
6547,A.C.O.D.,175705,175705,0,2013.csv,2013,100%,-
6548,Black Rock,175682,0,175682,2013.csv,2013,-,100%
6549,Champion,175232,175232,0,2017.csv,2017,100%,-
6550,Cleopatra's Second Husband,175058,175058,0,2000.csv,2000,100%,-
6551,Marooned in Iraq,174357,141243,33114,2003.csv,2003,81%,19%
6552,Stateside,174318,174318,0,2004.csv,2004,100%,-
6553,Always at The Carlyle,174251,174251,0,2018.csv,2018,100%,-
6554,Somm,174197,174197,0,2013.csv,2013,100%,-
6555,Grand Illusion,174065,174065,0,2012.csv,2012,100%,-
6556,The Closer You Get,174011,164927,9084,2000.csv,2000,94.8%,5.2%
6557,Mercy Streets,173599,173599,0,2000.csv,2000,100%,-
6558,Baptists at Our Barbecue,173306,173306,0,2004.csv,2004,100%,-
6559,Neon Bull,173219,26734,146485,2016.csv,2016,15.4%,84.6%
6560,Cirkus Columbia,173083,3457,169626,2011.csv,2011,2%,98%
6561,Them That Follow,172952,159218,13734,2019.csv,2019,92.1%,7.9%
6562,Bellflower,172935,168226,4709,2011.csv,2011,97.3%,2.7%
6563,Rodin 2017 Re-release,172619,44261,128358,2017.csv,2017,25.6%,74.4%
6564,Forty Shades of Blue,172569,75828,96741,2005.csv,2005,43.9%,56.1%
6565,Afternoon of a Faun: Tanaquil Le Clercq,172450,172450,0,2014.csv,2014,100%,-
6566,All Things Must Pass: The Rise and Fall of Tower Records,172394,172394,0,2015.csv,2015,100%,-
6567,Escape from Tomorrow,171962,171962,0,2013.csv,2013,100%,-
6568,Bolshoi Ballet: The Golden Age,171916,171916,0,2019.csv,2019,100%,-
6569,Little Woods,171912,150010,21902,2019.csv,2019,87.3%,12.7%
6570,Copperhead,171740,171740,0,2013.csv,2013,100%,-
6571,Abuse of Weakness,171660,31611,140049,2014.csv,2014,18.4%,81.6%
6572,United Passions,171511,607,170904,2014.csv,2014,0.4%,99.6%
6573,North Station,171400,171400,0,2002.csv,2002,100%,-
6574,The Bolshoi Ballet: Live From Moscow - La Sylphide,171177,171177,0,2018.csv,2018,100%,-
6575,Palau the Movie,171155,134696,36459,2019.csv,2019,78.7%,21.3%
6576,Cheerful Weather for the Wedding,170922,2651,168271,2012.csv,2012,1.6%,98.4%
6577,Uninvited Guest,170832,170832,0,2000.csv,2000,100%,-
6578,Apparition Hill,170457,170457,0,2016.csv,2016,100%,-
6579,The Human Centipede II (Full Sequence),170323,141877,28446,2011.csv,2011,83.3%,16.7%
6580,Knockout,169503,169503,0,2000.csv,2000,100%,-
6581,The Fits,169236,166425,2811,2016.csv,2016,98.3%,1.7%
6582,Viva Riva!,168982,61759,107223,2011.csv,2011,36.5%,63.5%
6583,Grizzly Falls,168874,168874,0,2000.csv,2000,100%,-
6584,Britt-Marie Was Here,168862,36549,132313,2019.csv,2019,21.6%,78.4%
6585,Girls of the Sun,168771,19712,149059,2018.csv,2018,11.7%,88.3%
6586,Valley of Bones,168738,168738,0,2017.csv,2017,100%,-
6587,Hangman's Curse,168406,168406,0,2003.csv,2003,100%,-
6588,De Palma,168045,165237,2808,2016.csv,2016,98.3%,1.7%
6589,Twentynine Palms,167999,54523,113476,2003.csv,2003,32.5%,67.5%
6590,The Clovehitch Killer,167994,8208,159786,2018.csv,2018,4.9%,95.1%
6591,The Bolshoi Ballet: Live From Moscow - The Lady of the Camellias,167991,167991,0,2018.csv,2018,100%,-
6592,Perrier's Bounty,167938,828,167110,2010.csv,2010,0.5%,99.5%
6593,Beauty and the Dogs,167723,8915,158808,2017.csv,2017,5.3%,94.7%
6594,Genius Within: The Inner Life of Glenn Gould,167508,167508,0,2010.csv,2010,100%,-
6595,Ziggy Stardust and the Spiders from Mars,167239,162547,4692,2002.csv,2002,97.2%,2.8%
6596,On_Line,167102,167102,0,2003.csv,2003,100%,-
6597,Is Genesis History? 2018 Re-release,166763,166763,0,2018.csv,2018,100%,-
6598,Phir Milenge,166484,91968,74516,2004.csv,2004,55.2%,44.8%
6599,The Day After,166022,24746,141276,2017.csv,2017,14.9%,85.1%
6600,Far From the Tree,166018,166018,0,2018.csv,2018,100%,-
6601,Fool for Love,165987,165987,0,2010.csv,2010,100%,-
6602,The Film Critic,165891,7358,158533,2014.csv,2014,4.4%,95.6%
6603,Bright Ones,165627,165627,0,2019.csv,2019,100%,-
6604,Solomon & Gaenor,165485,165485,0,2000.csv,2000,100%,-
6605,Maybe Baby,165046,20501,144545,2001.csv,2001,12.4%,87.6%
6606,Uncle Nino,165000,165000,0,2005.csv,2005,100%,-
6607,Christmas Eve,164839,91302,73537,2015.csv,2015,55.4%,44.6%
6608,Nas: Time Is Illmatic,164540,164540,0,2014.csv,2014,100%,-
6609,The Chambermaid,164531,86422,78109,2019.csv,2019,52.5%,47.5%
6610,Red Betsy,164520,164520,0,2003.csv,2003,100%,-
6611,Hybrid,164386,164386,0,2002.csv,2002,100%,-
6612,Eastern Boys,164290,16831,147459,2014.csv,2014,10.2%,89.8%
6613,Lost & Found,164026,125173,38853,2018.csv,2018,76.3%,23.7%
6614,Keep on Keepin' On,163745,163745,0,2014.csv,2014,100%,-
6615,Narco Cultura,163690,145088,18602,2013.csv,2013,88.6%,11.4%
6616,Halston,163446,151991,11455,2019.csv,2019,93%,7%
6617,Stolen Summer,163348,134736,28612,2002.csv,2002,82.5%,17.5%
6618,The Fassbinder Series,162885,162885,0,2003.csv,2003,100%,-
6619,Face,162717,108151,54566,2004.csv,2004,66.5%,33.5%
6620,Walking Out,162445,101947,60498,2017.csv,2017,62.8%,37.2%
6621,The Turin Horse,162088,56391,105697,2011.csv,2011,34.8%,65.2%
6622,Torremolinos 73 2005 Re-release,161651,87385,74266,2005.csv,2005,54.1%,45.9%
6623,Road to Nowhere,161619,40294,121325,2011.csv,2011,24.9%,75.1%
6624,The Samuel Project,161565,161565,0,2018.csv,2018,100%,-
6625,Mughal-E-Azam,161434,161434,0,2005.csv,2005,100%,-
6626,Lu Over the Wall,161253,109857,51396,2018.csv,2018,68.1%,31.9%
6627,Tharlo,161229,17091,144138,2016.csv,2016,10.6%,89.4%
6628,Spring Fever,161110,10824,150286,2010.csv,2010,6.7%,93.3%
6629,Bulgarian Lovers,161027,60712,100315,2003.csv,2003,37.7%,62.3%
6630,"Diana Ross: Her Life, Love and Legacy",160968,160968,0,2019.csv,2019,100%,-
6631,Gigantic (A Tale of Two Johns),160621,160621,0,2003.csv,2003,100%,-
6632,National Theatre Live: The Curious Incident of the Dog in the Night-Time 2018 Re-release,160381,160381,0,2018.csv,2018,100%,-
6633,Washington Heights,160291,160291,0,2003.csv,2003,100%,-
6634,Danny Deckchair 2004 Re-release,160276,160276,0,2004.csv,2004,100%,-
6635,Beauty and the Beast 2016 Re-release,160215,160215,0,2016.csv,2016,100%,-
6636,Punks,160083,160083,0,2001.csv,2001,100%,-
6637,Sinbad: The Fifth Voyage,159862,159862,0,2014.csv,2014,100%,-
6638,The Eclipse,159852,133411,26441,2010.csv,2010,83.5%,16.5%
6639,Murder 3,159798,0,159798,2013.csv,2013,-,100%
6640,The Model,159743,0,159743,2016.csv,2016,-,100%
6641,Eames: The Architect & The Painter,159715,153088,6627,2011.csv,2011,95.9%,4.1%
6642,When Will I Be Loved,159429,159429,0,2004.csv,2004,100%,-
6643,Km. 0 - Kilometer Zero,159338,159338,0,2003.csv,2003,100%,-
6644,The Witness,159305,159305,0,2016.csv,2016,100%,-
6645,We Are What We Are,159047,81381,77666,2013.csv,2013,51.2%,48.8%
6646,Until Forever,158872,35839,123033,2016.csv,2016,22.6%,77.4%
6647,The Last Resort,158646,158646,0,2018.csv,2018,100%,-
6648,The Big Picture 2012 Re-release,158411,158411,0,2012.csv,2012,100%,-
6649,Dev,158357,84728,73629,2004.csv,2004,53.5%,46.5%
6650,Mother of George,157937,157937,0,2013.csv,2013,100%,-
6651,The Look of Silence,157857,109089,48768,2015.csv,2015,69.1%,30.9%
6652,Crazy Horse,157782,157782,0,2012.csv,2012,100%,-
6653,Hell and Back,157768,157768,0,2015.csv,2015,100%,-
6654,Till Human Voices Wake Us,157720,120601,37119,2002.csv,2002,76.5%,23.5%
6655,House of Fools,157613,57862,99751,2003.csv,2003,36.7%,63.3%
6656,Chasing Madoff,157612,157612,0,2011.csv,2011,100%,-
6657,Eva Hesse,157481,157481,0,2016.csv,2016,100%,-
6658,Suntan,157267,6643,150624,2016.csv,2016,4.2%,95.8%
6659,Free the Mind,157201,157201,0,2013.csv,2013,100%,-
6660,Derrida,157200,157200,0,2002.csv,2002,100%,-
6661,LUV,156996,156996,0,2013.csv,2013,100%,-
6662,One Day in September,156818,156818,0,2000.csv,2000,100%,-
6663,Marina Abramovic: The Artist Is Present,156695,86637,70058,2012.csv,2012,55.3%,44.7%
6664,Jodi No.1,156415,82834,73581,2001.csv,2001,53%,47%
6665,Hatchet II,156190,52604,103586,2010.csv,2010,33.7%,66.3%
6666,Deadtime,156072,156072,0,2012.csv,2012,100%,-
6667,Pépé le Moko,155895,155895,0,2002.csv,2002,100%,-
6668,Queen & Country,155881,41297,114584,2015.csv,2015,26.5%,73.5%
6669,Matando Cabos 2005 Re-release,155874,155874,0,2005.csv,2005,100%,-
6670,Money,155732,155732,0,2019.csv,2019,100%,-
6671,Dans l'oeil du chat,155714,155714,0,2004.csv,2004,100%,-
6672,Naqoyqatsi,155640,133058,22582,2002.csv,2002,85.5%,14.5%
6673,Duck Season 2005 Re-release,155410,147551,7859,2005.csv,2005,94.9%,5.1%
6674,The Forgiveness of Blood,155383,126700,28683,2012.csv,2012,81.5%,18.5%
6675,The Gleaners & I,155320,155320,0,2001.csv,2001,100%,-
6676,Boy and the World 2015 Re-release,155215,129480,25735,2015.csv,2015,83.4%,16.6%
6677,Western,155215,41072,114143,2018.csv,2018,26.5%,73.5%
6678,Eating Out,155212,155212,0,2005.csv,2005,100%,-
6679,Magic Trip: Ken Kesey's Search for a Kool Place,155005,154521,484,2011.csv,2011,99.7%,0.3%
6680,Pantaleón y las visitadoras,154976,43214,111762,2002.csv,2002,27.9%,72.1%
6681,Hansel & Gretel,154642,154642,0,2002.csv,2002,100%,-
6682,Bad Reputation,154190,148568,5622,2018.csv,2018,96.4%,3.6%
6683,Eating Animals,153993,149614,4379,2018.csv,2018,97.2%,2.8%
6684,Suddenly,153985,44806,109179,2003.csv,2003,29.1%,70.9%
6685,Citizen Koch,153908,153908,0,2014.csv,2014,100%,-
6686,The Tag Along: Devil Fish,153895,20726,133169,2018.csv,2018,13.5%,86.5%
6687,The Revolution Will Not Be Televised,153859,153859,0,2003.csv,2003,100%,-
6688,The Terrorist,153629,153629,0,2000.csv,2000,100%,-
6689,Harmonium,153283,17191,136092,2017.csv,2017,11.2%,88.8%
6690,Backstreet Boys: Show 'Em What You're Made Of,153068,153068,0,2015.csv,2015,100%,-
6691,Quai des Orfèvres,152961,152961,0,2002.csv,2002,100%,-
6692,In the Shadow of Women,152802,50291,102511,2015.csv,2015,32.9%,67.1%
6693,Deceptive Practice: The Mysteries and Mentors of Ricky Jay,152791,152791,0,2013.csv,2013,100%,-
6694,Finding Fela!,152346,120980,31366,2014.csv,2014,79.4%,20.6%
6695,The Call Up,152294,0,152294,2016.csv,2016,-,100%
6696,Snake & Mongoose,152200,152200,0,2013.csv,2013,100%,-
6697,One Week and a Day,152178,41614,110564,2016.csv,2016,27.3%,72.7%
6698,"Buttons, A New Musical Film",151983,151983,0,2018.csv,2018,100%,-
6699,Born to Be Blue,151926,151926,0,2016.csv,2016,100%,-
6700,The Boys & Girl from County Clare,151869,142872,8997,2004.csv,2004,94.1%,5.9%
6701,Lupin the 3rd: Castle of Cagliostro 2017 Re-release,151802,142425,9377,2017.csv,2017,93.8%,6.2%
6702,Go Tigers!,151779,151779,0,2001.csv,2001,100%,-
6703,Dandelion,151755,0,151755,2005.csv,2005,-,100%
6704,Generation Found,151751,151751,0,2016.csv,2016,100%,-
6705,Garçon stupide,151702,151702,0,2005.csv,2005,100%,-
6706,Red Riding: The Year of Our Lord 1974,151644,151644,0,2010.csv,2010,100%,-
6707,Before You Know It,151507,151507,0,2019.csv,2019,100%,-
6708,Jay Myself,151331,151331,0,2019.csv,2019,100%,-
6709,Revenge of the Electric Car,151272,150886,386,2011.csv,2011,99.7%,0.3%
6710,The Cremaster Cycle 2010 Re-release,151239,151239,0,2010.csv,2010,100%,-
6711,Vampire Hunter D: Bloodlust,151086,151086,0,2001.csv,2001,100%,-
6712,Glory 2019 Re-release,150801,150801,0,2019.csv,2019,100%,-
6713,Tasting Menu,150718,18686,132032,2013.csv,2013,12.4%,87.6%
6714,Stoked: The Rise and Fall of Gator,150268,150268,0,2003.csv,2003,100%,-
6715,Godzilla 2014 Re-release,150191,150191,0,2014.csv,2014,100%,-
6716,Kicks,150191,150191,0,2016.csv,2016,100%,-
6717,Nobody Else But You,150173,43040,107133,2011.csv,2011,28.7%,71.3%
6718,Invincible,150143,81954,68189,2002.csv,2002,54.6%,45.4%
6719,Only the Brave,150000,150000,0,2010.csv,2010,100%,-
6720,The Day I Became a Woman,149971,149971,0,2001.csv,2001,100%,-
6721,Piercing,149211,15856,133355,2019.csv,2019,10.6%,89.4%
6722,Michael Moore in TrumpLand,149090,149090,0,2016.csv,2016,100%,-
6723,Gun Hill Road,148994,148994,0,2011.csv,2011,100%,-
6724,From Afar,148630,30169,118461,2016.csv,2016,20.3%,79.7%
6725,The Kingmaker,148611,122587,26024,2019.csv,2019,82.5%,17.5%
6726,Trial by Fire,148504,148504,0,2019.csv,2019,100%,-
6727,War and Peace,148503,148503,0,2019.csv,2019,100%,-
6728,Bartleby,148479,148479,0,2002.csv,2002,100%,-
6729,Tokyo Godfathers,148355,129560,18795,2003.csv,2003,87.3%,12.7%
6730,Harry Potter and the Deathly Hallows: Part 1 2018 Re-release,148263,148263,0,2018.csv,2018,100%,-
6731,Girls Will Be Girls,148047,148047,0,2003.csv,2003,100%,-
6732,Restless Creature: Wendy Whelan,147780,147780,0,2017.csv,2017,100%,-
6733,Night of the Living Dead 2018 Re-release,147423,147423,0,2018.csv,2018,100%,-
6734,The Strange Case of Angelica,147173,50135,97038,2010.csv,2010,34.1%,65.9%
6735,Driven,147172,0,147172,2019.csv,2019,-,100%
6736,Songs My Brothers Taught Me,146937,34793,112144,2015.csv,2015,23.7%,76.3%
6737,Ayurveda: Art of Being,146713,32267,114446,2001.csv,2001,22%,78%
6738,American Promise,146702,146702,0,2013.csv,2013,100%,-
6739,Watermark,146572,84464,62108,2014.csv,2014,57.6%,42.4%
6740,Dirty Deeds,146490,146490,0,2005.csv,2005,100%,-
6741,Touched with Fire,146487,146487,0,2016.csv,2016,100%,-
6742,Five Broken Cameras,146475,109983,36492,2012.csv,2012,75.1%,24.9%
6743,Biggie and Tupac,146419,94874,51545,2002.csv,2002,64.8%,35.2%
6744,Hannah,146325,11700,134625,2018.csv,2018,8%,92%
6745,Starlet,146222,88212,58010,2012.csv,2012,60.3%,39.7%
6746,Company Man,146193,146193,0,2001.csv,2001,100%,-
6747,Deadly Renovations,146146,146146,0,2012.csv,2012,100%,-
6748,The Punk Singer,146000,122742,23258,2013.csv,2013,84.1%,15.9%
6749,Citizen K,145941,120411,25530,2019.csv,2019,82.5%,17.5%
6750,Framing John DeLorean,145625,145625,0,2019.csv,2019,100%,-
6751,The Last Dalai Lama?,145524,145524,0,2017.csv,2017,100%,-
6752,Deterrence,145071,145071,0,2000.csv,2000,100%,-
6753,Krisha,144822,144822,0,2016.csv,2016,100%,-
6754,Mr. Smith Goes to Washington 2018 Re-release,144738,144738,0,2018.csv,2018,100%,-
6755,Irving Berlin's Holiday Inn The Broadway Musical,144550,144550,0,2017.csv,2017,100%,-
6756,The Price of Everything,144446,87400,57046,2018.csv,2018,60.5%,39.5%
6757,Yellow Day 2015 Re-release,144163,144163,0,2015.csv,2015,100%,-
6758,From Beneath,144123,144123,0,2012.csv,2012,100%,-
6759,Cold Weather,144056,141358,2698,2011.csv,2011,98.1%,1.9%
6760,Dahmer,144008,144008,0,2002.csv,2002,100%,-
6761,Thunder Soul,143986,143986,0,2011.csv,2011,100%,-
6762,Cop Car,143658,134552,9106,2015.csv,2015,93.7%,6.3%
6763,Undertow,143597,143597,0,2004.csv,2004,100%,-
6764,Dirty Girl,143485,55125,88360,2011.csv,2011,38.4%,61.6%
6765,X,143355,143355,0,2000.csv,2000,100%,-
6766,Doctor Who: Logopolis,143248,143248,0,2019.csv,2019,100%,-
6767,Alps,143234,16057,127177,2012.csv,2012,11.2%,88.8%
6768,Survival of the Dead,143191,101740,41451,2010.csv,2010,71.1%,28.9%
6769,Kids for Cash,143178,143178,0,2014.csv,2014,100%,-
6770,Clash,143121,18215,124906,2016.csv,2016,12.7%,87.3%
6771,The Lost Skeleton of Cadavra,143121,143121,0,2004.csv,2004,100%,-
6772,Aiyaary,143108,0,143108,2018.csv,2018,-,100%
6773,Dragon 2012 Re-release,142029,11137,130892,2012.csv,2012,7.8%,92.2%
6774,John Dies at the End,141951,141951,0,2013.csv,2013,100%,-
6775,Citadel,141886,13377,128509,2012.csv,2012,9.4%,90.6%
6776,May in the Summer,141605,22004,119601,2014.csv,2014,15.5%,84.5%
6777,Best F(r)iends Volume Two,141524,141524,0,2018.csv,2018,100%,-
6778,Music from the Inside Out,141504,141504,0,2005.csv,2005,100%,-
6779,Branagh Theatre Live: The Winter's Tale,141143,141143,0,2019.csv,2019,100%,-
6780,Zu Warriors,141084,0,141084,2003.csv,2003,-,100%
6781,Metropolis Giorgio Moroder Presents,140907,27362,113545,2011.csv,2011,19.4%,80.6%
6782,Canelo vs. Kovalev,140820,140820,0,2019.csv,2019,100%,-
6783,Gore Vidal: The United States of Amnesia,140164,140164,0,2014.csv,2014,100%,-
6784,Beautiful Boy,140123,77247,62876,2011.csv,2011,55.1%,44.9%
6785,The Weathered Underground,140091,140091,0,2010.csv,2010,100%,-
6786,Liv & Ingmar,140041,10347,129694,2012.csv,2012,7.4%,92.6%
6787,The Wizard of Oz 2002 Re-release,139905,139905,0,2002.csv,2002,100%,-
6788,Coherence,139745,102617,37128,2014.csv,2014,73.4%,26.6%
6789,Tigerland,139692,139692,0,2000.csv,2000,100%,-
6790,Hunky Dory,139653,20296,119357,2012.csv,2012,14.5%,85.5%
6791,Support the Girls,139550,129124,10426,2018.csv,2018,92.5%,7.5%
6792,Flowers,139421,61568,77853,2014.csv,2014,44.2%,55.8%
6793,Burden,139270,139270,0,2020.csv,2020,100%,-
6794,Wilder vs. Ortiz,139207,139207,0,2019.csv,2019,100%,-
6795,Rock on 2,139173,98868,40305,2016.csv,2016,71%,29%
6796,Kamikaze Girls 2005 Re-release,139139,34424,104715,2005.csv,2005,24.7%,75.3%
6797,The Polar Express 2014 IMAX Release,139055,139055,0,2014.csv,2014,100%,-
6798,Head Full of Honey,138844,12350,126494,2018.csv,2018,8.9%,91.1%
6799,Good Ol' Freda,138811,138811,0,2013.csv,2013,100%,-
6800,Zero Motivation,138609,116044,22565,2014.csv,2014,83.7%,16.3%
6801,The Brawler,138515,75929,62586,2018.csv,2018,54.8%,45.2%
6802,Beauty and the Beast 2002 Re-release,138503,138503,0,2002.csv,2002,100%,-
6803,Fear and Trembling 2004 Re-release,138436,126684,11752,2004.csv,2004,91.5%,8.5%
6804,Psycho-Pass: The Movie,138366,138366,0,2016.csv,2016,100%,-
6805,Brooklyn Lobster,138267,138267,0,2005.csv,2005,100%,-
6806,Who Will Write Our History,138039,138039,0,2019.csv,2019,100%,-
6807,Lynryd Skynyrd: Last of the Street Survivors Farewell Tour,137888,137888,0,2019.csv,2019,100%,-
6808,Love Ranch,137885,137885,0,2010.csv,2010,100%,-
6809,Super Sucker,137628,137628,0,2003.csv,2003,100%,-
6810,Time of Favor,137340,137340,0,2002.csv,2002,100%,-
6811,Is the Man Who Is Tall Happy?,137042,137042,0,2013.csv,2013,100%,-
6812,Slaughter Creek,136815,136815,0,2012.csv,2012,100%,-
6813,Road,136700,136700,0,2002.csv,2002,100%,-
6814,Swiri,135892,98452,37440,2001.csv,2001,72.4%,27.6%
6815,I Will Follow,135809,135809,0,2011.csv,2011,100%,-
6816,Mantra: Sounds Into Silence,135684,115013,20671,2018.csv,2018,84.8%,15.2%
6817,Sonchiriya,135413,86765,48648,2019.csv,2019,64.1%,35.9%
6818,Sapience,135392,135392,0,2015.csv,2015,100%,-
6819,The Kind Words,135382,135382,0,2016.csv,2016,100%,-
6820,The Ninth Day,135311,72888,62423,2005.csv,2005,53.9%,46.1%
6821,The Cherry Orchard,135280,135280,0,2002.csv,2002,100%,-
6822,The Other Dream Team,135228,135228,0,2012.csv,2012,100%,-
6823,The Other Story,135191,135191,0,2019.csv,2019,100%,-
6824,The Bolshoi Ballet: Live From Moscow - A Hero of Our Time,135168,104837,30331,2017.csv,2017,77.6%,22.4%
6825,My Neighbor Totoro 2015 Re-release,134877,0,134877,2015.csv,2015,-,100%
6826,Another Day of Life,134801,3190,131611,2018.csv,2018,2.4%,97.6%
6827,Led Zeppelin: Celebration Day,134753,0,134753,2012.csv,2012,-,100%
6828,Concert for George,134600,134600,0,2003.csv,2003,100%,-
6829,Attenberg,134503,24036,110467,2010.csv,2010,17.9%,82.1%
6830,Made in Abyss: Journey's Dawn,134194,134047,147,2019.csv,2019,99.9%,0.1%
6831,Ism,134165,134165,0,2016.csv,2016,100%,-
6832,Redwood Highway,134049,134049,0,2014.csv,2014,100%,-
6833,Lunacy,133982,48324,85658,2005.csv,2005,36.1%,63.9%
6834,The Great Museum,133905,18020,115885,2014.csv,2014,13.5%,86.5%
6835,Pure Country 2: The Gift,133771,133771,0,2010.csv,2010,100%,-
6836,Don't Think I've Forgotten: Cambodia's Lost Rock & Roll,133443,133443,0,2015.csv,2015,100%,-
6837,Under the Shadow,133324,31900,101424,2016.csv,2016,23.9%,76.1%
6838,The Jewish Cardinal,133232,133232,0,2014.csv,2014,100%,-
6839,Be Natural: The Untold Story of Alice Guy-Blaché,133183,115265,17918,2019.csv,2019,86.5%,13.5%
6840,A Shot at Glory,133122,133122,0,2002.csv,2002,100%,-
6841,"Hare Krishna! The Mantra, the Movement and the Swami Who Started It",133006,133006,0,2017.csv,2017,100%,-
6842,Crying Ladies,132920,132920,0,2004.csv,2004,100%,-
6843,Tonight You're Mine,132787,6255,126532,2011.csv,2011,4.7%,95.3%
6844,Hukkle,132745,53715,79030,2003.csv,2003,40.5%,59.5%
6845,Harry Potter and the Order of the Phoenix 2018 Re-release,132522,132522,0,2018.csv,2018,100%,-
6846,1+1=11,132498,132498,0,2003.csv,2003,100%,-
6847,Dawson City: Frozen Time,132369,132369,0,2016.csv,2016,100%,-
6848,Sonny,132221,30005,102216,2002.csv,2002,22.7%,77.3%
6849,Kumaré,132160,132160,0,2012.csv,2012,100%,-
6850,My Brother the Devil,132056,44906,87150,2012.csv,2012,34%,66%
6851,How to Survive a Plague,132055,132055,0,2012.csv,2012,100%,-
6852,A Ballerina's Tale,131995,131995,0,2015.csv,2015,100%,-
6853,Mugamoodi,131965,101000,30965,2012.csv,2012,76.5%,23.5%
6854,Touchez Pas au Grisbi,131548,131548,0,2003.csv,2003,100%,-
6855,Robot Stories,131451,131451,0,2004.csv,2004,100%,-
6856,28 Hotel Rooms,131208,18869,112339,2012.csv,2012,14.4%,85.6%
6857,Rudy 2018 Re-release,131200,131200,0,2018.csv,2018,100%,-
6858,Son frère,131195,22834,108361,2003.csv,2003,17.4%,82.6%
6859,The Wind,130974,28252,102722,2019.csv,2019,21.6%,78.4%
6860,Mister America,130897,130897,0,2019.csv,2019,100%,-
6861,The Image Book,130802,94153,36649,2018.csv,2018,72%,28%
6862,Saheb Biwi Aur Gangster 3,130403,0,130403,2018.csv,2018,-,100%
6863,Little Monsters,130381,0,130381,2019.csv,2019,-,100%
6864,October,130335,32127,98208,2010.csv,2010,24.6%,75.4%
6865,Five Seasons: The Gardens of Piet Oudolf,130319,119223,11096,2018.csv,2018,91.5%,8.5%
6866,Requiem for the American Dream,130152,130152,0,2016.csv,2016,100%,-
6867,Harry Potter and the Half-Blood Prince 2018 Re-release,130081,130081,0,2018.csv,2018,100%,-
6868,Be Here to Love Me: A Film About Townes Van Zandt,129988,129988,0,2005.csv,2005,100%,-
6869,Section 375,129916,0,129916,2019.csv,2019,-,100%
6870,The Fairy,129818,38399,91419,2011.csv,2011,29.6%,70.4%
6871,The Metropolitan Opera HD Live: Puccini: Madama Butterfly,129730,129730,0,2018.csv,2018,100%,-
6872,The Metropolitan Opera HD Live: Tchaikovsky: Eugene Onegin 2018 Re-release,129498,129498,0,2018.csv,2018,100%,-
6873,The Metropolitan Opera HD Live: Verdi: Il Trovatore,129393,129393,0,2018.csv,2018,100%,-
6874,Dil Jo Bhi Kahey...,129319,129319,0,2005.csv,2005,100%,-
6875,Maryam,129265,129265,0,2002.csv,2002,100%,-
6876,I Called Him Morgan,128986,128986,0,2017.csv,2017,100%,-
6877,The Golden Era 2014 Re-release,128926,102931,25995,2014.csv,2014,79.8%,20.2%
6878,Yossi,128668,117047,11621,2012.csv,2012,91%,9%
6879,The Adventurer: The Curse of the Midas Box,128471,6399,122072,2014.csv,2014,5%,95%
6880,Where Hands Touch,128269,67743,60526,2018.csv,2018,52.8%,47.2%
6881,Stonewall Uprising,128203,128203,0,2010.csv,2010,100%,-
6882,Computer Chess,127852,102041,25811,2013.csv,2013,79.8%,20.2%
6883,Steve Jobs: The Lost Interview,127541,105710,21831,2011.csv,2011,82.9%,17.1%
6884,American Chai,127518,127518,0,2002.csv,2002,100%,-
6885,Benda Bilili!,127362,13420,113942,2010.csv,2010,10.5%,89.5%
6886,Sleepless in Seattle 2018 Re-release,127281,127281,0,2018.csv,2018,100%,-
6887,A Band Called Death,127257,127257,0,2013.csv,2013,100%,-
6888,Friends and Family,127212,127212,0,2003.csv,2003,100%,-
6889,O Fantasma,126783,126783,0,2002.csv,2002,100%,-
6890,Chimes at Midnight,126724,126724,0,2016.csv,2016,100%,-
6891,Silent Night,126594,14567,112027,2012.csv,2012,11.5%,88.5%
6892,Escape Fire: The Fight to Rescue American Healthcare,126238,126238,0,2012.csv,2012,100%,-
6893,The Arbor,126182,21620,104562,2010.csv,2010,17.1%,82.9%
6894,Baran,125900,125900,0,2001.csv,2001,100%,-
6895,The Great Buster,125807,118344,7463,2018.csv,2018,94.1%,5.9%
6896,Europa Report,125687,125687,0,2013.csv,2013,100%,-
6897,Paris Is Burning 2019 Re-release,125677,125677,0,2019.csv,2019,100%,-
6898,Green Card Fever,125596,125596,0,2003.csv,2003,100%,-
6899,This Changes Everything,125348,64988,60360,2019.csv,2019,51.8%,48.2%
6900,The B-Side: Elsa Dorfman's Portrait Photography,125227,125227,0,2017.csv,2017,100%,-
6901,Spinning Plates,124856,112449,12407,2013.csv,2013,90.1%,9.9%
6902,Mary Magdalene 2019 Re-release,124741,124741,0,2019.csv,2019,100%,-
6903,Every Secret Thing,124733,103536,21197,2015.csv,2015,83%,17%
6904,Hymn: Sarah Brightman In Concert,124707,113274,11433,2018.csv,2018,90.8%,9.2%
6905,Ran 2010 Re-release,124673,124673,0,2010.csv,2010,100%,-
6906,'85: The Greatest Team in Football History,124573,124573,0,2018.csv,2018,100%,-
6907,Final: The Rapture,124561,124561,0,2013.csv,2013,100%,-
6908,Vidal Sassoon: The Movie,124532,85974,38558,2011.csv,2011,69%,31%
6909,Singin' in the Rain 2002 Re-release,124382,120420,3962,2002.csv,2002,96.8%,3.2%
6910,Post Tenebras Lux,124279,39185,85094,2012.csv,2012,31.5%,68.5%
6911,The Square,124244,124244,0,2013.csv,2013,100%,-
6912,Marguerite & Julien,123918,0,123918,2015.csv,2015,-,100%
6913,Knights of Badassdom,123854,123854,0,2014.csv,2014,100%,-
6914,Wings of Desire 2018 Re-release,123830,123830,0,2018.csv,2018,100%,-
6915,The Magic of Belle Isle,123821,102388,21433,2012.csv,2012,82.7%,17.3%
6916,Puncture,123700,68945,54755,2011.csv,2011,55.7%,44.3%
6917,Appropriate Behavior,123699,46912,76787,2015.csv,2015,37.9%,62.1%
6918,Sigur Rós: Inni,123482,123482,0,2011.csv,2011,100%,-
6919,Easy Rider 2019 Re-release,123276,123276,0,2019.csv,2019,100%,-
6920,The Last Mountain,122961,122961,0,2011.csv,2011,100%,-
6921,Ashby,122919,4631,118288,2015.csv,2015,3.8%,96.2%
6922,Secret Ballot,122875,114909,7966,2002.csv,2002,93.5%,6.5%
6923,Blood Fest,122833,82774,40059,2018.csv,2018,67.4%,32.6%
6924,"14 Days, 12 Nights",122806,122530,276,2020.csv,2020,99.8%,0.2%
6925,Do I Sound Gay?,122595,119388,3207,2015.csv,2015,97.4%,2.6%
6926,Film socialisme 2010 Re-release,122264,42925,79339,2010.csv,2010,35.1%,64.9%
6927,Tragedy Girls,122211,61899,60312,2017.csv,2017,50.6%,49.4%
6928,Dancing at the Blue Iguana,122121,67913,54208,2001.csv,2001,55.6%,44.4%
6929,Howard Zinn: You Can't Be Neutral on a Moving Train,122011,122011,0,2004.csv,2004,100%,-
6930,The Ones Below,121827,12488,109339,2016.csv,2016,10.3%,89.7%
6931,Tremors,121813,23911,97902,2019.csv,2019,19.6%,80.4%
6932,A Tuba to Cuba,121772,121772,0,2019.csv,2019,100%,-
6933,Yu-Gi-Oh!: The Movie - Pyramid of Light 2018 Re-release,121688,121688,0,2018.csv,2018,100%,-
6934,Fidel,121304,121304,0,2002.csv,2002,100%,-
6935,All the Queen's Men,121258,23662,97596,2001.csv,2001,19.5%,80.5%
6936,Letters to Elena,121254,8511,112743,2012.csv,2012,7%,93%
6937,Afflicted,121179,121179,0,2014.csv,2014,100%,-
6938,Love After Love,121098,121098,0,2018.csv,2018,100%,-
6939,In Jackson Heights,121094,121094,0,2015.csv,2015,100%,-
6940,Michael,121034,15715,105319,2011.csv,2011,13%,87%
6941,The Girl Without Hands,121020,21787,99233,2016.csv,2016,18%,82%
6942,Miss Sharon Jones!,120880,120880,0,2016.csv,2016,100%,-
6943,Better Living Through Chemistry,120823,75143,45680,2014.csv,2014,62.2%,37.8%
6944,Hockney 2016 Re-release,120745,120745,0,2016.csv,2016,100%,-
6945,Cowgirls 'n Angels,120680,120680,0,2012.csv,2012,100%,-
6946,Sons of Provo,120488,120488,0,2005.csv,2005,100%,-
6947,Spark: A Burning Man Story,120459,120459,0,2013.csv,2013,100%,-
6948,I Vitelloni 2003 Re-release,120343,116428,3915,2003.csv,2003,96.7%,3.3%
6949,Foodfight!,120141,0,120141,2012.csv,2012,-,100%
6950,Blank City,119929,116037,3892,2011.csv,2011,96.8%,3.2%
6951,Avant qu'on explose,119894,119894,0,2019.csv,2019,100%,-
6952,The Pearl Button,119753,42166,77587,2015.csv,2015,35.2%,64.8%
6953,Amy's Orgasm,119664,119664,0,2002.csv,2002,100%,-
6954,The Komediant,119506,119506,0,2002.csv,2002,100%,-
6955,Digging for Fire,119364,119364,0,2015.csv,2015,100%,-
6956,Valley of the Heart's Delight,119290,119290,0,2010.csv,2010,100%,-
6957,Celine: Through the Eyes of the World,119274,0,119274,2010.csv,2010,-,100%
6958,Fellini: I'm a Born Liar,119217,106686,12531,2003.csv,2003,89.5%,10.5%
6959,Remember the Goal,119100,119100,0,2016.csv,2016,100%,-
6960,Home Movie,119052,119052,0,2002.csv,2002,100%,-
6961,Until Forever 2016 Re-release,118795,105358,13437,2016.csv,2016,88.7%,11.3%
6962,Neither Heaven Nor Earth,118663,12810,105853,2015.csv,2015,10.8%,89.2%
6963,The Levelling,118451,3040,115411,2017.csv,2017,2.6%,97.4%
6964,See What I'm Saying: The Deaf Entertainers Documentary,118206,118206,0,2010.csv,2010,100%,-
6965,Styx 2018 Re-release,118188,70794,47394,2018.csv,2018,59.9%,40.1%
6966,Victor,117755,117755,0,2016.csv,2016,100%,-
6967,The Decoy Bride,117754,759,116995,2011.csv,2011,0.6%,99.4%
6968,Freakonomics,117678,101270,16408,2010.csv,2010,86.1%,13.9%
6969,Running Free,117608,117608,0,2000.csv,2000,100%,-
6970,Spring Forward,117471,117471,0,2000.csv,2000,100%,-
6971,Bisbee '17,117470,117470,0,2018.csv,2018,100%,-
6972,George Takei's Allegiance 2018 Re-release,117162,117162,0,2018.csv,2018,100%,-
6973,Jauja 2014 Re-release,117117,60231,56886,2014.csv,2014,51.4%,48.6%
6974,"Love, Sex and Eating the Bones",116869,116869,0,2004.csv,2004,100%,-
6975,Skin,116863,0,116863,2019.csv,2019,-,100%
6976,Gimme the Loot,116783,104442,12341,2013.csv,2013,89.4%,10.6%
6977,A Case of You,116559,4187,112372,2013.csv,2013,3.6%,96.4%
6978,The Undefeated,116381,116381,0,2011.csv,2011,100%,-
6979,Touching Home,116353,116353,0,2010.csv,2010,100%,-
6980,The Art of Flight,116134,0,116134,2012.csv,2012,-,100%
6981,Mob Psycho 100,115766,115766,0,2019.csv,2019,100%,-
6982,I Am Divine,115739,81497,34242,2013.csv,2013,70.4%,29.6%
6983,Headshot,115511,1373,114138,2011.csv,2011,1.2%,98.8%
6984,Loggerheads,115314,115314,0,2005.csv,2005,100%,-
6985,Caged No More,114959,114959,0,2016.csv,2016,100%,-
6986,Sound and Fury,114882,114882,0,2000.csv,2000,100%,-
6987,Nostalgia,114603,114603,0,2018.csv,2018,100%,-
6988,Taboo,114425,114425,0,2000.csv,2000,100%,-
6989,John McEnroe: In the Realm of Perfection,114289,90964,23325,2018.csv,2018,79.6%,20.4%
6990,Kippur,114283,114283,0,2000.csv,2000,100%,-
6991,After Innocence,114264,114264,0,2005.csv,2005,100%,-
6992,Akira 2001 Re-release,114009,114009,0,2001.csv,2001,100%,-
6993,Ain't in It for My Health: A Film About Levon Helm,113966,113966,0,2013.csv,2013,100%,-
6994,Bodied,113956,113956,0,2018.csv,2018,100%,-
6995,The Woman Who Loves Giraffes,113858,113858,0,2019.csv,2019,100%,-
6996,35 and Ticking,113794,113794,0,2011.csv,2011,100%,-
6997,Seaside,113724,15290,98434,2002.csv,2002,13.4%,86.6%
6998,Games People Play: New York,113622,113622,0,2004.csv,2004,100%,-
6999,The Goonies 2013 Re-release,113538,113538,0,2013.csv,2013,100%,-
7000,"We Love You, Sally Carmichael!",113435,113435,0,2017.csv,2017,100%,-
7001,Abacus: Small Enough to Jail,113278,113278,0,2017.csv,2017,100%,-
7002,God the Father,113276,113276,0,2014.csv,2014,100%,-
7003,Burn 2012 Re-release,113173,113173,0,2012.csv,2012,100%,-
7004,Road Hard,113169,113169,0,2015.csv,2015,100%,-
7005,Food of Love,113164,43922,69242,2002.csv,2002,38.8%,61.2%
7006,Police Story,113164,113164,0,2019.csv,2019,100%,-
7007,Filmworker,112828,102609,10219,2018.csv,2018,90.9%,9.1%
7008,Follow Me: The Yoni Netanyahu Story,112679,112679,0,2012.csv,2012,100%,-
7009,A Boy. A Girl. A Dream.,112552,112552,0,2018.csv,2018,100%,-
7010,The Recall,112357,22943,89414,2017.csv,2017,20.4%,79.6%
7011,"Hale County This Morning, This Evening",112282,112282,0,2018.csv,2018,100%,-
7012,The Dawn Wall,112191,112191,0,2018.csv,2018,100%,-
7013,Penton: The John Penton Story,112159,112159,0,2014.csv,2014,100%,-
7014,How Viktor 'The Garlic' Took Alexey 'The Stud' to the Nursing Home,112071,12954,99117,2017.csv,2017,11.6%,88.4%
7015,Marwencol,112036,112036,0,2010.csv,2010,100%,-
7016,A Chance in the World - Premiere,112007,112007,0,2018.csv,2018,100%,-
7017,Una noche,111903,100887,11016,2013.csv,2013,90.2%,9.8%
7018,The Producers,111866,111866,0,2002.csv,2002,100%,-
7019,Hometown Legend,111806,111806,0,2002.csv,2002,100%,-
7020,Saint John of Las Vegas,111731,102645,9086,2010.csv,2010,91.9%,8.1%
7021,1915,111682,111682,0,2015.csv,2015,100%,-
7022,Thomas in Love,111523,44256,67267,2001.csv,2001,39.7%,60.3%
7023,Deewaar: Let's Bring Our Heroes Home,111423,111423,0,2004.csv,2004,100%,-
7024,Rich Hill,111376,111376,0,2014.csv,2014,100%,-
7025,Love the Hard Way,111350,44391,66959,2003.csv,2003,39.9%,60.1%
7026,Elevator to the Gallows 2016 Re-release,111267,111267,0,2016.csv,2016,100%,-
7027,"Wild Horse, Wild Ride",111205,111205,0,2012.csv,2012,100%,-
7028,A Paris Education,111197,21598,89599,2018.csv,2018,19.4%,80.6%
7029,Strangerland,111107,17472,93635,2015.csv,2015,15.7%,84.3%
7030,The Obama Effect,110904,110904,0,2012.csv,2012,100%,-
7031,The Overnighters,110763,110763,0,2014.csv,2014,100%,-
7032,Duran Duran: Unstaged,110746,110746,0,2014.csv,2014,100%,-
7033,Word Wars,110617,110617,0,2004.csv,2004,100%,-
7034,In the Face of Evil: Reagan's War in Word and Deed,110577,110577,0,2004.csv,2004,100%,-
7035,The Perfect Family,110313,110313,0,2012.csv,2012,100%,-
7036,The Trouble with Terkel,110289,110289,0,2017.csv,2017,100%,-
7037,Roar,110048,110048,0,2015.csv,2015,100%,-
7038,Best Worst Movie,109895,109895,0,2010.csv,2010,100%,-
7039,The Fifth Element 2017 Re-release,109786,0,109786,2017.csv,2017,-,100%
7040,Babylon,109749,109749,0,2019.csv,2019,100%,-
7041,Zero Days,109649,109649,0,2016.csv,2016,100%,-
7042,Anohana: The Flower We Saw That Day - The Movie,109630,109630,0,2014.csv,2014,100%,-
7043,Cameraperson,109464,102033,7431,2016.csv,2016,93.2%,6.8%
7044,Wedding Party 2,109459,11140,98319,2017.csv,2017,10.2%,89.8%
7045,Blood Done Sign My Name,109383,109383,0,2010.csv,2010,100%,-
7046,The Lure,108846,101657,7189,2017.csv,2017,93.4%,6.6%
7047,Adult Beginners,108808,108808,0,2015.csv,2015,100%,-
7048,Sworn Virgin,108681,4636,104045,2015.csv,2015,4.3%,95.7%
7049,Monsieur N. 2004 Re-release,108631,37757,70874,2004.csv,2004,34.8%,65.2%
7050,Red Sorghum,108371,0,108371,2018.csv,2018,-,100%
7051,Violet & Daisy,108139,17186,90953,2013.csv,2013,15.9%,84.1%
7052,Bettie Page Reveals All,108118,108118,0,2013.csv,2013,100%,-
7053,Downtown 81,108058,108058,0,2001.csv,2001,100%,-
7054,"Love, Cecil",107940,106057,1883,2017.csv,2017,98.3%,1.7%
7055,The Kidnapping of Michel Houellebecq,107641,11546,96095,2014.csv,2014,10.7%,89.3%
7056,Bonjour Monsieur Shlomi,107585,107585,0,2004.csv,2004,100%,-
7057,Revenge of the Green Dragons,107412,0,107412,2014.csv,2014,-,100%
7058,"No Date, No Signature",107368,36444,70924,2018.csv,2018,33.9%,66.1%
7059,Cockneys vs Zombies,107348,0,107348,2012.csv,2012,-,100%
7060,Marebito,107259,13983,93276,2005.csv,2005,13%,87%
7061,A Slipping-Down Life,107099,107099,0,2004.csv,2004,100%,-
7062,National Theatre Live: Julius Caesar,107057,107057,0,2018.csv,2018,100%,-
7063,Carlos Castaneda: Enigma of a Sorcerer,107040,107040,0,2004.csv,2004,100%,-
7064,Jeruzalem,107024,11287,95737,2016.csv,2016,10.5%,89.5%
7065,Best Worst Thing That Ever Could Have Happened...,106986,106986,0,2016.csv,2016,100%,-
7066,The Tales of Hoffmann,106860,91930,14930,2015.csv,2015,86%,14%
7067,Ivory Tower,106771,106771,0,2014.csv,2014,100%,-
7068,Vita Activa: The Spirit of Hannah Arendt,106768,82143,24625,2016.csv,2016,76.9%,23.1%
7069,Dekalog 2016 Re-release,106494,106494,0,2016.csv,2016,100%,-
7070,Wrong,106425,46021,60404,2012.csv,2012,43.2%,56.8%
7071,The Charmer,106379,26167,80212,2018.csv,2018,24.6%,75.4%
7072,Six Dance Lessons in Six Weeks,106323,106323,0,2014.csv,2014,100%,-
7073,The Bachelors,106212,0,106212,2017.csv,2017,-,100%
7074,Almost Peaceful 2004 Re-release,106184,106184,0,2004.csv,2004,100%,-
7075,The Brink,106057,106057,0,2019.csv,2019,100%,-
7076,Big Star: Nothing Can Hurt Me,105998,105998,0,2013.csv,2013,100%,-
7077,The Million Dollar Hotel,105983,59989,45994,2000.csv,2000,56.6%,43.4%
7078,Never Heard,105271,105271,0,2018.csv,2018,100%,-
7079,Guerrilla: The Taking of Patty Hearst,105054,105054,0,2004.csv,2004,100%,-
7080,Cold Case Hammarskjöld,104965,104965,0,2019.csv,2019,100%,-
7081,The Girl,104883,104883,0,2001.csv,2001,100%,-
7082,A Ciambra,104808,41934,62874,2017.csv,2017,40%,60%
7083,Dictator,104734,104734,0,2016.csv,2016,100%,-
7084,Band Baaja Baaraat,104532,43820,60712,2010.csv,2010,41.9%,58.1%
7085,Results,104507,104507,0,2015.csv,2015,100%,-
7086,Big Bad Love,104294,104294,0,2002.csv,2002,100%,-
7087,Human Traffic,104257,104257,0,2000.csv,2000,100%,-
7088,XX/XY,104130,104130,0,2003.csv,2003,100%,-
7089,Demon,104038,104038,0,2016.csv,2016,100%,-
7090,Lola,103951,103951,0,2001.csv,2001,100%,-
7091,World Traveler,103863,103863,0,2002.csv,2002,100%,-
7092,The Investigator,103739,103739,0,2013.csv,2013,100%,-
7093,30 Years to Life,103540,103540,0,2002.csv,2002,100%,-
7094,Stevie,103401,103401,0,2003.csv,2003,100%,-
7095,Stevie Nicks: In Your Dreams,103028,103028,0,2013.csv,2013,100%,-
7096,Puerto Ricans in Paris,102890,102890,0,2016.csv,2016,100%,-
7097,Brake,102819,4876,97943,2012.csv,2012,4.7%,95.3%
7098,Pure,102471,102471,0,2005.csv,2005,100%,-
7099,The Gracefield Incident,102256,0,102256,2017.csv,2017,-,100%
7100,Tanna,102225,46654,55571,2016.csv,2016,45.6%,54.4%
7101,Andrei Rublev 2018 Re-release,102021,102021,0,2018.csv,2018,100%,-
7102,Becoming Traviata,102015,62652,39363,2013.csv,2013,61.4%,38.6%
7103,Tower,101987,101987,0,2016.csv,2016,100%,-
7104,In the Family,101934,101934,0,2011.csv,2011,100%,-
7105,Hotel by the River,101879,28354,73525,2019.csv,2019,27.8%,72.2%
7106,Kill Me Three Times,101807,24296,77511,2015.csv,2015,23.9%,76.1%
7107,Magnus,101739,8944,92795,2016.csv,2016,8.8%,91.2%
7108,Those Who Remained,101737,0,101737,2019.csv,2019,-,100%
7109,Rubber,101729,100370,1359,2011.csv,2011,98.7%,1.3%
7110,Kickboxer: Retaliation,101690,4537,97153,2018.csv,2018,4.5%,95.5%
7111,A Lego Brickumentary,101531,101531,0,2015.csv,2015,100%,-
7112,Blazing Saddles 2013 Re-release,101481,101481,0,2013.csv,2013,100%,-
7113,Man from Reno,101438,101438,0,2015.csv,2015,100%,-
7114,James White,101368,101368,0,2015.csv,2015,100%,-
7115,Emerald Cowboy,101358,101358,0,2003.csv,2003,100%,-
7116,Korengal,101310,101310,0,2014.csv,2014,100%,-
7117,Feed the Fish,101170,101170,0,2010.csv,2010,100%,-
7118,Beyond Sight: The Derek Rabelo Story,101074,101074,0,2014.csv,2014,100%,-
7119,First Cow,101068,101068,0,2020.csv,2020,100%,-
7120,Dum,101000,101000,0,2003.csv,2003,100%,-
7121,Khauff,100975,100975,0,2000.csv,2000,100%,-
7122,The Good Guy,100688,100688,0,2010.csv,2010,100%,-
7123,A Woman Is a Woman,100665,100665,0,2003.csv,2003,100%,-
7124,Sade,100544,100544,0,2002.csv,2002,100%,-
7125,The Man Who Fell to Earth,100468,100072,396,2011.csv,2011,99.6%,0.4%
7126,The United States of Autism,100403,100403,0,2013.csv,2013,100%,-
7127,One Track Heart: The Story of Krishna Das,100401,100401,0,2013.csv,2013,100%,-
7128,QT8: The First Eight,100396,51896,48500,2019.csv,2019,51.7%,48.3%
7129,All About Nina,100335,100335,0,2018.csv,2018,100%,-
7130,8: The Mormon Proposition,100280,100280,0,2010.csv,2010,100%,-
7131,Rejoice and Shout,100237,100237,0,2011.csv,2011,100%,-
7132,Bhutto,100202,100202,0,2010.csv,2010,100%,-
7133,Fighter,99938,99938,0,2001.csv,2001,100%,-
7134,Yves Saint Laurent: His Life and Times,99819,99819,0,2004.csv,2004,100%,-
7135,White Lion,99635,0,99635,2010.csv,2010,-,100%
7136,Heavy Water,99503,55446,44057,2019.csv,2019,55.7%,44.3%
7137,Meow Wolf: Origin Story,99488,99488,0,2018.csv,2018,100%,-
7138,Kings of the Evening,99270,99270,0,2010.csv,2010,100%,-
7139,Carnage,99049,60158,38891,2002.csv,2002,60.7%,39.3%
7140,Cemetery of Splendor,98932,51950,46982,2015.csv,2015,52.5%,47.5%
7141,Handcart,98666,98666,0,2002.csv,2002,100%,-
7142,High Strung Free Dance 2019 Re-release,98481,83891,14590,2019.csv,2019,85.2%,14.8%
7143,Aida's Secrets,98468,98468,0,2017.csv,2017,100%,-
7144,Reign of Judges: Title of Liberty - Concept Short,98408,93224,5184,2018.csv,2018,94.7%,5.3%
7145,Blind,98280,12522,85758,2017.csv,2017,12.7%,87.3%
7146,Charlie Says,98240,40685,57555,2019.csv,2019,41.4%,58.6%
7147,National Theatre Live: Macbeth,97857,97857,0,2018.csv,2018,100%,-
7148,"Tim Timmerman, Hope of America",97727,97727,0,2017.csv,2017,100%,-
7149,The Here After,97699,0,97699,2015.csv,2015,-,100%
7150,On Guard,97552,97552,0,2002.csv,2002,100%,-
7151,D.E.B.S.,97446,97446,0,2005.csv,2005,100%,-
7152,Aileen: Life and Death of a Serial Killer,97362,97362,0,2004.csv,2004,100%,-
7153,Everybody's Famous!,97353,81734,15619,2001.csv,2001,84%,16%
7154,In Bloom,97236,56092,41144,2013.csv,2013,57.7%,42.3%
7155,Difret,97205,49667,47538,2015.csv,2015,51.1%,48.9%
7156,Prassthanam,97204,19984,77220,2019.csv,2019,20.6%,79.4%
7157,A Field in England,97195,32846,64349,2013.csv,2013,33.8%,66.2%
7158,Kisses 2010 Re-release,96933,81680,15253,2010.csv,2010,84.3%,15.7%
7159,A Little Help,96868,96868,0,2011.csv,2011,100%,-
7160,Leviathan,96778,76202,20576,2013.csv,2013,78.7%,21.3%
7161,Singin' in the Rain 2013 Re-release,96763,96763,0,2013.csv,2013,100%,-
7162,Hardflip,96734,96734,0,2012.csv,2012,100%,-
7163,Sunshine Superman,96715,88097,8618,2015.csv,2015,91.1%,8.9%
7164,Godspeed: The Race Across America,96690,96690,0,2018.csv,2018,100%,-
7165,Paragraph 175,96630,96630,0,2000.csv,2000,100%,-
7166,A Poem Is a Naked Person,96592,96592,0,2015.csv,2015,100%,-
7167,Dina,96524,90503,6021,2017.csv,2017,93.8%,6.2%
7168,Hiroshima Mon Amour 2014 Re-release,96439,96439,0,2014.csv,2014,100%,-
7169,Autumn Spring 2003 Re-release,96269,96269,0,2003.csv,2003,100%,-
7170,Saint Judy,96212,78935,17277,2019.csv,2019,82%,18%
7171,My Reincarnation,96115,92822,3293,2011.csv,2011,96.6%,3.4%
7172,A Bigger Splash 2019 Re-release,95826,95826,0,2019.csv,2019,100%,-
7173,Ardor,95549,18565,76984,2014.csv,2014,19.4%,80.6%
7174,The Lovers & the Despot,95521,55511,40010,2016.csv,2016,58.1%,41.9%
7175,Kehtaa Hai Dil Baar Baar,95415,95415,0,2002.csv,2002,100%,-
7176,Classe Tous Risques,95413,95413,0,2005.csv,2005,100%,-
7177,Code Unknown,95242,95242,0,2001.csv,2001,100%,-
7178,The Final Wish,95215,25183,70032,2019.csv,2019,26.4%,73.6%
7179,The Night Eats the World,95208,0,95208,2018.csv,2018,-,100%
7180,Queen of Earth,95183,91218,3965,2015.csv,2015,95.8%,4.2%
7181,Saala Khadoos,94787,76931,17856,2016.csv,2016,81.2%,18.8%
7182,The Hebrew Hammer,94615,82157,12458,2003.csv,2003,86.8%,13.2%
7183,Jin-Roh: The Wolf Brigade,94591,94591,0,2001.csv,2001,100%,-
7184,The Fight Within,94326,94326,0,2016.csv,2016,100%,-
7185,Papi Chulo,94321,84703,9618,2019.csv,2019,89.8%,10.2%
7186,Keep Watching,94178,94178,0,2017.csv,2017,100%,-
7187,Escaflowne: The Movie,94060,94060,0,2002.csv,2002,100%,-
7188,Blue Caprice,93995,93995,0,2013.csv,2013,100%,-
7189,Let the Corpses Tan,93409,93409,0,2018.csv,2018,100%,-
7190,Flavors,93370,93370,0,2004.csv,2004,100%,-
7191,Will You Still Love Me Tomorrow?,93046,6694,86352,2013.csv,2013,7.2%,92.8%
7192,Celsius 41.11: The Temperature at Which the Brain... Begins to Die,93000,93000,0,2004.csv,2004,100%,-
7193,Vamps,92748,3361,89387,2012.csv,2012,3.6%,96.4%
7194,Haiku Tunnel,92723,92723,0,2001.csv,2001,100%,-
7195,The First Time,92654,22836,69818,2012.csv,2012,24.6%,75.4%
7196,American: The Bill Hicks Story,92234,92234,0,2011.csv,2011,100%,-
7197,Into the Forest,92166,9995,82171,2016.csv,2016,10.8%,89.2%
7198,Nancy,92000,80115,11885,2018.csv,2018,87.1%,12.9%
7199,Generation War,91595,91595,0,2014.csv,2014,100%,-
7200,Legends from the Sky,91462,91462,0,2015.csv,2015,100%,-
7201,Other People,91441,91441,0,2016.csv,2016,100%,-
7202,Evil Bong 3: The Wrath of Bong,91260,91260,0,2011.csv,2011,100%,-
7203,Morris from America,91151,91151,0,2016.csv,2016,100%,-
7204,A Kind of Murder,91149,2915,88234,2016.csv,2016,3.2%,96.8%
7205,Mapplethorpe,91002,91002,0,2019.csv,2019,100%,-
7206,BANDSTAND: The Broadway Musical on Screen 2018 Re-release,91000,91000,0,2018.csv,2018,100%,-
7207,Undead 2005 Re-release,90928,41196,49732,2005.csv,2005,45.3%,54.7%
7208,Because of Grácia,90878,90878,0,2017.csv,2017,100%,-
7209,Ek Khiladi Ek Haseena,90869,90869,0,2005.csv,2005,100%,-
7210,Porto,90849,15126,75723,2017.csv,2017,16.6%,83.4%
7211,Heropanti,90785,63649,27136,2014.csv,2014,70.1%,29.9%
7212,Beasts of No Nation,90777,90777,0,2015.csv,2015,100%,-
7213,Yuri!!! On Ice,90751,81878,8873,2018.csv,2018,90.2%,9.8%
7214,Loopers: The Caddie's Long Walk,90679,90679,0,2019.csv,2019,100%,-
7215,Moonwalkers,90646,0,90646,2016.csv,2016,-,100%
7216,The Good Neighbor,90573,0,90573,2016.csv,2016,-,100%
7217,Fireworks Wednesday 2016 Re-release,90519,90519,0,2016.csv,2016,100%,-
7218,Minding the Gap,90328,11998,78330,2018.csv,2018,13.3%,86.7%
7219,Dark Horse,90136,90136,0,2015.csv,2015,100%,-
7220,King's Faith,90106,90106,0,2013.csv,2013,100%,-
7221,Running for Grace,89988,89988,0,2018.csv,2018,100%,-
7222,Pump,89787,89787,0,2014.csv,2014,100%,-
7223,Eulogy,89781,75076,14705,2004.csv,2004,83.6%,16.4%
7224,The Principle,89543,89543,0,2014.csv,2014,100%,-
7225,Oy Vey! My Son Is Gay!!,89507,89507,0,2010.csv,2010,100%,-
7226,Somebody Up There Likes Me,89435,89435,0,2013.csv,2013,100%,-
7227,Cat on a Hot Tin Roof,89332,89332,0,2018.csv,2018,100%,-
7228,Salvation Boulevard,89182,28468,60714,2011.csv,2011,31.9%,68.1%
7229,Night of the Living Dead,89029,89029,0,2017.csv,2017,100%,-
7230,This Is Not a Film,88758,77016,11742,2012.csv,2012,86.8%,13.2%
7231,The Lumber Baron,88336,88336,0,2019.csv,2019,100%,-
7232,Crazy on the Outside,88335,88335,0,2010.csv,2010,100%,-
7233,Jewtopia,88327,46437,41890,2013.csv,2013,52.6%,47.4%
7234,Money for Nothing: Inside the Federal Reserve,88045,88045,0,2013.csv,2013,100%,-
7235,Jim Allison: Breakthrough,87984,87984,0,2019.csv,2019,100%,-
7236,Seeing Other People,87923,87923,0,2004.csv,2004,100%,-
7237,Hyena Road,87768,1430,86338,2015.csv,2015,1.6%,98.4%
7238,The Cartel,87763,87763,0,2010.csv,2010,100%,-
7239,Ocean Waves,87738,87738,0,2016.csv,2016,100%,-
7240,Glory,87728,18415,69313,2017.csv,2017,21%,79%
7241,Exporting Raymond,87727,87727,0,2011.csv,2011,100%,-
7242,Author: The JT LeRoy Story,87686,85999,1687,2016.csv,2016,98.1%,1.9%
7243,Goldstone 2018 Re-release,87639,87639,0,2018.csv,2018,100%,-
7244,Pulse 2005 Re-release,87420,51420,36000,2005.csv,2005,58.8%,41.2%
7245,Borstal Boy,87400,87400,0,2002.csv,2002,100%,-
7246,First Morning,87264,87264,0,2005.csv,2005,100%,-
7247,To Fall in Love,87000,87000,0,2000.csv,2000,100%,-
7248,War Photographer,86863,61040,25823,2002.csv,2002,70.3%,29.7%
7249,ECCO,86858,86858,0,2019.csv,2019,100%,-
7250,Singularity,86822,4176,82646,2017.csv,2017,4.8%,95.2%
7251,Vault,86741,29491,57250,2019.csv,2019,34%,66%
7252,Güeros,86736,60114,26622,2015.csv,2015,69.3%,30.7%
7253,School Life,86616,37381,49235,2017.csv,2017,43.2%,56.8%
7254,Beuys,86451,65410,21041,2018.csv,2018,75.7%,24.3%
7255,"My Love, Don't Cross That River 2016 Re-release",86446,86446,0,2016.csv,2016,100%,-
7256,Prey for Rock & Roll,86277,58040,28237,2003.csv,2003,67.3%,32.7%
7257,Crazy Wisdom: The Life & Times of Chogyam Trungpa Rinpoche,86202,86202,0,2011.csv,2011,100%,-
7258,Rapt 2011 Re-release,86028,45759,40269,2011.csv,2011,53.2%,46.8%
7259,Bay of Angels,85840,85840,0,2001.csv,2001,100%,-
7260,Tab Hunter Confidential,85812,85812,0,2015.csv,2015,100%,-
7261,Where's the Party Yaar?,85739,85739,0,2003.csv,2003,100%,-
7262,Jackals,85410,0,85410,2017.csv,2017,-,100%
7263,The Good Old Naughty Days,85006,60862,24144,2002.csv,2002,71.6%,28.4%
7264,Skid Row Marathon,84997,84997,0,2019.csv,2019,100%,-
7265,Three... Extremes 2005 Re-release,84976,77532,7444,2005.csv,2005,91.2%,8.8%
7266,Waking Sleeping Beauty,84918,80741,4177,2010.csv,2010,95.1%,4.9%
7267,Ran 2016 Re-release,84789,66097,18692,2016.csv,2016,78%,22%
7268,Decoys,84733,84733,0,2004.csv,2004,100%,-
7269,Live Nude Girls Unite!,84706,84706,0,2000.csv,2000,100%,-
7270,Wretches & Jabberers,84610,84610,0,2011.csv,2011,100%,-
7271,Visitors,84577,84577,0,2014.csv,2014,100%,-
7272,Woodstock,84440,84440,0,2019.csv,2019,100%,-
7273,Heaven Knows What,84417,80734,3683,2015.csv,2015,95.6%,4.4%
7274,The Diabolical,84259,0,84259,2015.csv,2015,-,100%
7275,Chapter & Verse,84147,84147,0,2017.csv,2017,100%,-
7276,Los Sures,83992,83992,0,2016.csv,2016,100%,-
7277,"Nico, 1988",83558,73304,10254,2018.csv,2018,87.7%,12.3%
7278,Barely Legal,83439,26511,56928,2005.csv,2005,31.8%,68.2%
7279,ABCD,83372,83372,0,2001.csv,2001,100%,-
7280,The Look,83137,19988,63149,2011.csv,2011,24%,76%
7281,Hateship Loveship,83008,54030,28978,2014.csv,2014,65.1%,34.9%
7282,Alien Abduction,82725,12897,69828,2014.csv,2014,15.6%,84.4%
7283,Doctor Who: The Woman Who Fell to Earth,82698,82698,0,2018.csv,2018,100%,-
7284,12 O'Clock Boys,82614,82614,0,2014.csv,2014,100%,-
7285,Funny Ha Ha,82528,77070,5458,2005.csv,2005,93.4%,6.6%
7286,V/H/S Viral,82409,2756,79653,2014.csv,2014,3.3%,96.7%
7287,The Treasure,82392,50203,32189,2016.csv,2016,60.9%,39.1%
7288,Better Living Through Circuitry,82378,82378,0,2000.csv,2000,100%,-
7289,Water & Power,82312,82312,0,2014.csv,2014,100%,-
7290,Prey,82258,0,82258,2019.csv,2019,-,100%
7291,Careful What You Wish For,82230,0,82230,2015.csv,2015,-,100%
7292,The Whale,81881,81881,0,2011.csv,2011,100%,-
7293,Bhavesh Joshi Superhero,81792,57376,24416,2018.csv,2018,70.1%,29.9%
7294,Best Man in Grass Creek,81760,81760,0,2001.csv,2001,100%,-
7295,King Cobra,81757,81757,0,2016.csv,2016,100%,-
7296,Inkubus,81600,81600,0,2011.csv,2011,100%,-
7297,'R Xmas,81476,850,80626,2001.csv,2001,1%,99%
7298,Anything But Love,81451,81451,0,2003.csv,2003,100%,-
7299,A State of Mind,81450,41468,39982,2005.csv,2005,50.9%,49.1%
7300,Hating Breitbart,81432,81432,0,2012.csv,2012,100%,-
7301,The Girl in the Book,81379,8245,73134,2015.csv,2015,10.1%,89.9%
7302,The Future of Food,81280,81280,0,2005.csv,2005,100%,-
7303,Yomeddine,81030,11308,69722,2018.csv,2018,14%,86%
7304,The Island President,80996,76398,4598,2012.csv,2012,94.3%,5.7%
7305,Burning Bush,80943,16731,64212,2013.csv,2013,20.7%,79.3%
7306,Woman Walks Ahead,80912,57528,23384,2018.csv,2018,71.1%,28.9%
7307,Brother to Brother,80906,80906,0,2004.csv,2004,100%,-
7308,The Big Blue 2000 Director's Cut,80882,80882,0,2000.csv,2000,100%,-
7309,Taur Mittran Di,80879,69510,11369,2012.csv,2012,85.9%,14.1%
7310,Chrystal,80858,80858,0,2005.csv,2005,100%,-
7311,Kind Hearts and Coronets 2019 Re-release,80795,35948,44847,2019.csv,2019,44.5%,55.5%
7312,Nasty Baby,80772,79800,972,2015.csv,2015,98.8%,1.2%
7313,Trace Amounts,80735,80735,0,2015.csv,2015,100%,-
7314,Batman Returns 2019 Re-release,80699,70642,10057,2019.csv,2019,87.5%,12.5%
7315,Ms. Purple,80657,80657,0,2019.csv,2019,100%,-
7316,Enemies of the People,80654,73171,7483,2010.csv,2010,90.7%,9.3%
7317,Winnie Mandela,80634,80634,0,2013.csv,2013,100%,-
7318,Always Kabhi Kabhi,80546,21381,59165,2011.csv,2011,26.5%,73.5%
7319,Ginger Snaps 2: Unleashed,80372,80372,0,2004.csv,2004,100%,-
7320,Free Radicals,80371,1443,78928,2003.csv,2003,1.8%,98.2%
7321,Songs from the Second Floor,80334,80334,0,2001.csv,2001,100%,-
7322,Armstrong,80169,19740,60429,2019.csv,2019,24.6%,75.4%
7323,For the Love of Spock,80141,80141,0,2016.csv,2016,100%,-
7324,Inhale,80112,4115,75997,2010.csv,2010,5.1%,94.9%
7325,Ramaiya Vastavaiya,80108,80108,0,2013.csv,2013,100%,-
7326,Jack Paradise (Les nuits de Montréal),79974,79974,0,2004.csv,2004,100%,-
7327,Searching for the Wrong-Eyed Jesus,79916,79916,0,2005.csv,2005,100%,-
7328,En el séptimo día,79887,79887,0,2018.csv,2018,100%,-
7329,Made-Up,79766,79766,0,2003.csv,2003,100%,-
7330,"Sobibór, October 14, 1943, 4 p.m.",79728,41040,38688,2001.csv,2001,51.5%,48.5%
7331,Aurangzeb,79665,0,79665,2013.csv,2013,-,100%
7332,Harvest of Empire,79627,79627,0,2012.csv,2012,100%,-
7333,Camp X-Ray,79624,13302,66322,2014.csv,2014,16.7%,83.3%
7334,End of the Century,79607,66309,13298,2019.csv,2019,83.3%,16.7%
7335,Jayne Mansfield's Car,79178,14836,64342,2013.csv,2013,18.7%,81.3%
7336,Concussion,78957,42606,36351,2013.csv,2013,54%,46%
7337,Fort McCoy,78948,78948,0,2014.csv,2014,100%,-
7338,Christ Stopped at Eboli,78736,78736,0,2019.csv,2019,100%,-
7339,The Boxcar Children - Surprise Island,78676,78676,0,2018.csv,2018,100%,-
7340,Blackbird,78400,78400,0,2015.csv,2015,100%,-
7341,Harold and Lillian: A Hollywood Love Story,78301,78301,0,2017.csv,2017,100%,-
7342,Colliding Dreams,78288,78288,0,2016.csv,2016,100%,-
7343,Anesthesia,78270,32163,46107,2016.csv,2016,41.1%,58.9%
7344,Un traductor,78075,13509,64566,2018.csv,2018,17.3%,82.7%
7345,Jodi Breakers,78024,52618,25406,2012.csv,2012,67.4%,32.6%
7346,Bright Leaves,77888,77888,0,2004.csv,2004,100%,-
7347,Baraka 2002 Re-release,77873,77873,0,2002.csv,2002,100%,-
7348,Table No. 21,77621,46720,30901,2013.csv,2013,60.2%,39.8%
7349,Chevalier,77590,25696,51894,2015.csv,2015,33.1%,66.9%
7350,The Princess Blade,77567,77567,0,2003.csv,2003,100%,-
7351,Circo,77466,77466,0,2011.csv,2011,100%,-
7352,The Art of the Steal,77450,64065,13385,2014.csv,2014,82.7%,17.3%
7353,Breaking Upwards,77389,77389,0,2010.csv,2010,100%,-
7354,To Catch a Dollar: Muhammad Yunus Banks on America,77142,77142,0,2011.csv,2011,100%,-
7355,Parchi,77110,69431,7679,2018.csv,2018,90%,10%
7356,The Missing Picture,76933,52164,24769,2014.csv,2014,67.8%,32.2%
7357,Fast Colour,76916,76916,0,2019.csv,2019,100%,-
7358,How the West Was Won 2003 Re-release,76729,76729,0,2003.csv,2003,100%,-
7359,Eisenstein in Guanajuato 2015 Re-release,76713,34282,42431,2015.csv,2015,44.7%,55.3%
7360,Mademoiselle C,76621,48668,27953,2013.csv,2013,63.5%,36.5%
7361,Blue Moon,76544,76544,0,2000.csv,2000,100%,-
7362,The New Rijksmuseum - The Film,76460,40578,35882,2015.csv,2015,53.1%,46.9%
7363,Steal This Movie,76424,76424,0,2000.csv,2000,100%,-
7364,Swimming Upstream 2004 Re-release,76287,54965,21322,2004.csv,2004,72.1%,27.9%
7365,Night Catches Us,76185,76185,0,2010.csv,2010,100%,-
7366,Don't Blink - Robert Frank,76134,76134,0,2016.csv,2016,100%,-
7367,93Queen,76056,76056,0,2018.csv,2018,100%,-
7368,Whitey: United States of America v. James J. Bulger,75881,75881,0,2014.csv,2014,100%,-
7369,Wish You Were Here 2013 Re-release,75870,46347,29523,2013.csv,2013,61.1%,38.9%
7370,Into the White 2013 Re-release,75747,704,75043,2013.csv,2013,0.9%,99.1%
7371,Touch Me Not,75507,13782,61725,2018.csv,2018,18.3%,81.7%
7372,The Riot Act,75506,75506,0,2018.csv,2018,100%,-
7373,Swim Little Fish Swim,75504,3877,71627,2014.csv,2014,5.1%,94.9%
7374,Hum To Mohabbat Karega,75446,75446,0,2000.csv,2000,100%,-
7375,"Love, Antosha",75308,50168,25140,2019.csv,2019,66.6%,33.4%
7376,Restaurant,75232,75232,0,2000.csv,2000,100%,-
7377,An Everlasting Piece,75228,75228,0,2000.csv,2000,100%,-
7378,Widespread Panic: The Earth Will Swallow You,75204,75204,0,2002.csv,2002,100%,-
7379,Bill Nye: Science Guy,74909,74909,0,2017.csv,2017,100%,-
7380,The Ornithologist,74714,50511,24203,2016.csv,2016,67.6%,32.4%
7381,Above and Beyond: NASA's Journey to Tomorrow,74711,74711,0,2018.csv,2018,100%,-
7382,Batkid Begins: The Wish Heard Around the World,74709,74709,0,2015.csv,2015,100%,-
7383,The Monster,74700,12544,62156,2016.csv,2016,16.8%,83.2%
7384,The War Within,74655,74655,0,2005.csv,2005,100%,-
7385,We Come as Friends,74633,50921,23712,2014.csv,2014,68.2%,31.8%
7386,The Nomi Song,74631,74631,0,2005.csv,2005,100%,-
7387,Hadewijch,74586,5006,69580,2010.csv,2010,6.7%,93.3%
7388,Stations of the Cross,74509,1505,73004,2014.csv,2014,2%,98%
7389,Reset,74341,5454,68887,2016.csv,2016,7.3%,92.7%
7390,Set Me Free,74052,74052,0,2000.csv,2000,100%,-
7391,The Boy Downstairs,73988,13638,60350,2018.csv,2018,18.4%,81.6%
7392,The Keeping Room,73922,27166,46756,2015.csv,2015,36.7%,63.3%
7393,After Auschwitz,73885,73885,0,2018.csv,2018,100%,-
7394,War Pigs,73701,0,73701,2015.csv,2015,-,100%
7395,Wait for Your Laugh,73585,73585,0,2017.csv,2017,100%,-
7396,Prodigal Sons,73544,73544,0,2010.csv,2010,100%,-
7397,On the Ice,73492,73492,0,2012.csv,2012,100%,-
7398,Primal Rage: The Legend of Konga,73383,21497,51886,2018.csv,2018,29.3%,70.7%
7399,Father and Son,73351,39291,34060,2004.csv,2004,53.6%,46.4%
7400,Vengeance: A Love Story,73270,4526,68744,2017.csv,2017,6.2%,93.8%
7401,Te Ata,73236,73236,0,2017.csv,2017,100%,-
7402,Antonio Lopez 1970: Sex Fashion & Disco,73122,43169,29953,2018.csv,2018,59%,41%
7403,Buster's Mal Heart,73121,73121,0,2017.csv,2017,100%,-
7404,Headshot,73010,0,73010,2017.csv,2017,-,100%
7405,5B,72968,72968,0,2019.csv,2019,100%,-
7406,Come Away Home,72810,72810,0,2005.csv,2005,100%,-
7407,Do Not Resist,72791,72791,0,2016.csv,2016,100%,-
7408,The Seagull's Laughter,72527,72527,0,2004.csv,2004,100%,-
7409,Dorian Blues,72234,72234,0,2005.csv,2005,100%,-
7410,Loving Jezebel,72190,72190,0,2000.csv,2000,100%,-
7411,The Green Wave,72152,0,72152,2011.csv,2011,-,100%
7412,Partisan,72151,0,72151,2015.csv,2015,-,100%
7413,After Tiller,72125,72125,0,2013.csv,2013,100%,-
7414,Hollywood Buddha,72115,72115,0,2004.csv,2004,100%,-
7415,Veil of Tears,72078,72078,0,2014.csv,2014,100%,-
7416,Naked in Ashes,72073,72073,0,2005.csv,2005,100%,-
7417,The Invisible War,71968,71968,0,2012.csv,2012,100%,-
7418,The Chambermaid Lynn,71918,315,71603,2015.csv,2015,0.4%,99.6%
7419,Raiders!: The Story of the Greatest Fan Film Ever Made,71916,71916,0,2016.csv,2016,100%,-
7420,An Oversimplification of Her Beauty,71906,71906,0,2013.csv,2013,100%,-
7421,Greener Grass,71838,51456,20382,2019.csv,2019,71.6%,28.4%
7422,Umberto D.,71816,71816,0,2002.csv,2002,100%,-
7423,As I Lay Dying,71759,16697,55062,2013.csv,2013,23.3%,76.7%
7424,New Suit,71743,71743,0,2003.csv,2003,100%,-
7425,Runaway Slave,71737,71737,0,2012.csv,2012,100%,-
7426,Flamenco Flamenco 2014 Re-release,71732,71732,0,2014.csv,2014,100%,-
7427,"Je t'aime, je t'aime 2014 Re-release",71717,71717,0,2014.csv,2014,100%,-
7428,The Dummy,71646,71646,0,2003.csv,2003,100%,-
7429,Herman U.S.A.,71509,71509,0,2001.csv,2001,100%,-
7430,The Congressman,71451,71451,0,2016.csv,2016,100%,-
7431,The Sicilian Girl 2010 Re-release,71239,71239,0,2010.csv,2010,100%,-
7432,My Journey Through French Cinema,71174,52214,18960,2016.csv,2016,73.4%,26.6%
7433,Free Trip to Egypt 2019 Re-release,71087,71087,0,2019.csv,2019,100%,-
7434,Boricua's Bond,71046,71046,0,2000.csv,2000,100%,-
7435,Rosencrantz and Guildenstern Are Undead,71007,71007,0,2010.csv,2010,100%,-
7436,Freaks of Nature,70958,70958,0,2015.csv,2015,100%,-
7437,Norman Lear: Just Another Version of You,70950,70950,0,2016.csv,2016,100%,-
7438,Todo el poder,70920,70920,0,2003.csv,2003,100%,-
7439,The Better Angels,70918,70918,0,2014.csv,2014,100%,-
7440,4:44 Last Day on Earth,70851,17801,53050,2012.csv,2012,25.1%,74.9%
7441,Seasons of Gray,70605,70605,0,2013.csv,2013,100%,-
7442,Fireflies in the Garden 2011 Re-release,70600,70600,0,2011.csv,2011,100%,-
7443,Snipes,70569,70569,0,2002.csv,2002,100%,-
7444,Go for Sisters,70495,70495,0,2013.csv,2013,100%,-
7445,The Fog 2018 Re-release,70421,70421,0,2018.csv,2018,100%,-
7446,Over Your Cities Grass Will Grow,70256,51301,18955,2010.csv,2010,73%,27%
7447,Wastelander,70045,70045,0,2018.csv,2018,100%,-
7448,Manic,69958,69958,0,2003.csv,2003,100%,-
7449,Turn It Around: The Story of East Bay Punk,69787,69787,0,2017.csv,2017,100%,-
7450,Mga munting tinig,69739,69739,0,2003.csv,2003,100%,-
7451,Assassination of a High School President,69564,0,69564,2010.csv,2010,-,100%
7452,Dopamine,69544,69544,0,2003.csv,2003,100%,-
7453,Chef Flynn,69542,68407,1135,2018.csv,2018,98.4%,1.6%
7454,Back to the Jurassic,69423,4351,65072,2015.csv,2015,6.3%,93.7%
7455,An Inconsistent Truth,69394,69394,0,2012.csv,2012,100%,-
7456,BBC2 Play of the Week: Langrishe Go Down,69338,69338,0,2002.csv,2002,100%,-
7457,Siddharth,69310,60537,8773,2014.csv,2014,87.3%,12.7%
7458,Rocky Handsome,69289,0,69289,2016.csv,2016,-,100%
7459,Girls Can't Swim,69250,69250,0,2002.csv,2002,100%,-
7460,Bajatey Raho,69085,55397,13688,2013.csv,2013,80.2%,19.8%
7461,The Pinochet Case,68934,35701,33233,2001.csv,2001,51.8%,48.2%
7462,My Entire High School Sinking Into the Sea,68883,68883,0,2017.csv,2017,100%,-
7463,Klown 2012 Re-release,68795,68795,0,2012.csv,2012,100%,-
7464,Strange Powers: Stephin Merritt and the Magnetic Fields,68719,68719,0,2010.csv,2010,100%,-
7465,Bundy,68716,6073,62643,2002.csv,2002,8.8%,91.2%
7466,Noma My Perfect Storm,68622,21130,47492,2015.csv,2015,30.8%,69.2%
7467,Take Me to the River,68598,68598,0,2014.csv,2014,100%,-
7468,Mastizaade,68583,43403,25180,2016.csv,2016,63.3%,36.7%
7469,Wildflower,68577,18062,50515,2016.csv,2016,26.3%,73.7%
7470,Cowboys and Angels,68568,33941,34627,2004.csv,2004,49.5%,50.5%
7471,Outside In,68492,68492,0,2018.csv,2018,100%,-
7472,Alive and Kicking,68485,68485,0,2017.csv,2017,100%,-
7473,Last Year at Marienbad 2019 Re-release,68402,63425,4977,2019.csv,2019,92.7%,7.3%
7474,Budrus,68353,68353,0,2010.csv,2010,100%,-
7475,2012: Time for Change,68339,68339,0,2010.csv,2010,100%,-
7476,The Eyes of Orson Welles,68328,10253,58075,2018.csv,2018,15%,85%
7477,10x10,68260,2263,65997,2018.csv,2018,3.3%,96.7%
7478,Shake Hands with the Devil: The Journey of Roméo Dallaire,68249,68249,0,2005.csv,2005,100%,-
7479,Maidentrip,68243,68243,0,2013.csv,2013,100%,-
7480,Le Amiche,68167,68167,0,2010.csv,2010,100%,-
7481,¡He matado a mi marido!,68017,45777,22240,2019.csv,2019,67.3%,32.7%
7482,I Am Big Bird: The Caroll Spinney Story,67845,67845,0,2015.csv,2015,100%,-
7483,The Messenger,67816,67816,0,2015.csv,2015,100%,-
7484,Summer in the Forest,67743,45542,22201,2017.csv,2017,67.2%,32.8%
7485,Sanam Teri Kasam,67736,22121,45615,2016.csv,2016,32.7%,67.3%
7486,What Alice Found,67436,67436,0,2003.csv,2003,100%,-
7487,Beyond the Gates,67433,67433,0,2004.csv,2004,100%,-
7488,The Greasy Strangler,67427,45878,21549,2016.csv,2016,68%,32%
7489,For No Good Reason,67421,67421,0,2014.csv,2014,100%,-
7490,Making the Five Heartbeats,67415,67415,0,2018.csv,2018,100%,-
7491,Being Frank,67343,67343,0,2019.csv,2019,100%,-
7492,The Doctor from India,67136,67136,0,2018.csv,2018,100%,-
7493,The Sun Behind the Clouds: Tibet's Struggle for Freedom,67095,67095,0,2010.csv,2010,100%,-
7494,The Autobiography of Nicolae Ceausescu,67093,34023,33070,2010.csv,2010,50.7%,49.3%
7495,Turbo Kid,67069,67069,0,2015.csv,2015,100%,-
7496,Side by Side,67054,58825,8229,2012.csv,2012,87.7%,12.3%
7497,"3100, Run and Become",66789,65524,1265,2018.csv,2018,98.1%,1.9%
7498,Pandora's Promise,66680,66680,0,2013.csv,2013,100%,-
7499,Max Rose,66680,66680,0,2016.csv,2016,100%,-
7500,Vodka Lemon,66361,66361,0,2004.csv,2004,100%,-
7501,The Town Is Quiet,66303,66303,0,2001.csv,2001,100%,-
7502,King Georges,66175,66175,0,2016.csv,2016,100%,-
7503,Dancing Across Borders,66166,66166,0,2010.csv,2010,100%,-
7504,Out in the Dark,66017,26966,39051,2013.csv,2013,40.8%,59.2%
7505,The Talent Given Us,65827,65827,0,2005.csv,2005,100%,-
7506,Titanic Town,65793,65793,0,2000.csv,2000,100%,-
7507,D-Day,65536,0,65536,2013.csv,2013,-,100%
7508,Architects of Denial,65424,65424,0,2017.csv,2017,100%,-
7509,Blind Shaft,65383,33272,32111,2003.csv,2003,50.9%,49.1%
7510,Mail Order Wife,65369,62387,2982,2005.csv,2005,95.4%,4.6%
7511,Sing Your Song,65310,47718,17592,2012.csv,2012,73.1%,26.9%
7512,Mad About Mambo,65283,65283,0,2000.csv,2000,100%,-
7513,Spooky House,65238,65238,0,2002.csv,2002,100%,-
7514,You've Been Trumped,65220,29273,35947,2012.csv,2012,44.9%,55.1%
7515,One 2004 Re-release,65172,65172,0,2004.csv,2004,100%,-
7516,An Adolescent 2005 Re-release,65171,65171,0,2005.csv,2005,100%,-
7517,Through a Lens Darkly: Black Photographers and the Emergence of a People,65169,65169,0,2014.csv,2014,100%,-
7518,The Lesson,65142,9045,56097,2015.csv,2015,13.9%,86.1%
7519,Gaudi Afternoon,65115,5858,59257,2002.csv,2002,9%,91%
7520,Aberdeen,65090,65090,0,2001.csv,2001,100%,-
7521,Racing Dreams,65082,65082,0,2010.csv,2010,100%,-
7522,Last Resort,65041,37283,27758,2001.csv,2001,57.3%,42.7%
7523,Toys in the Attic 2012 Re-release,64918,64918,0,2012.csv,2012,100%,-
7524,Manolo: the Boy Who Made Shoes for Lizards,64889,60056,4833,2017.csv,2017,92.6%,7.4%
7525,Searching for Ingmar Bergman,64742,36686,28056,2018.csv,2018,56.7%,43.3%
7526,"Monrovia, Indiana",64596,63944,652,2018.csv,2018,99%,1%
7527,Battle of the Brides,64572,64572,0,2011.csv,2011,100%,-
7528,Let the Fire Burn,64489,64489,0,2013.csv,2013,100%,-
7529,Trilogy: The Weeping Meadow,64424,24966,39458,2005.csv,2005,38.8%,61.2%
7530,Badmaa$h Company,64398,0,64398,2010.csv,2010,-,100%
7531,Just a Kiss,64389,64389,0,2002.csv,2002,100%,-
7532,Rock School,64310,64310,0,2005.csv,2005,100%,-
7533,Paulette 2015 Re-release,64125,29494,34631,2015.csv,2015,46%,54%
7534,Girl Asleep,64056,60289,3767,2016.csv,2016,94.1%,5.9%
7535,Making Waves: The Art of Cinematic Sound,63998,53144,10854,2019.csv,2019,83%,17%
7536,Jealousy,63946,63946,0,2014.csv,2014,100%,-
7537,Only the Strong Survive,63778,57581,6197,2003.csv,2003,90.3%,9.7%
7538,Her Majesty,63652,63652,0,2004.csv,2004,100%,-
7539,The Details,63595,63595,0,2012.csv,2012,100%,-
7540,A Liar's Autobiography: The Untrue Story of Monty Python's Graham Chapman,63469,5102,58367,2012.csv,2012,8%,92%
7541,All About Eve 2000 Re-release,63463,63463,0,2000.csv,2000,100%,-
7542,I Smile Back,63373,58738,4635,2015.csv,2015,92.7%,7.3%
7543,Nijinsky: The Diaries of Vaslav Nijinsky,63364,55968,7396,2002.csv,2002,88.3%,11.7%
7544,Trapped,63241,63241,0,2016.csv,2016,100%,-
7545,The Last of the Unjust,63136,40563,22573,2013.csv,2013,64.2%,35.8%
7546,No Tears for the Dead,63063,63063,0,2014.csv,2014,100%,-
7547,Creative Control,63014,63014,0,2016.csv,2016,100%,-
7548,The Mudge Boy,62852,62852,0,2004.csv,2004,100%,-
7549,The Gardener,62734,62734,0,2018.csv,2018,100%,-
7550,The Swan,62716,2367,60349,2018.csv,2018,3.8%,96.2%
7551,Cool It,62713,62713,0,2010.csv,2010,100%,-
7552,No Such Thing,62703,62703,0,2002.csv,2002,100%,-
7553,A Year Without Love,62676,24381,38295,2005.csv,2005,38.9%,61.1%
7554,Drunk Stoned Brilliant Dead,62660,62660,0,2015.csv,2015,100%,-
7555,The Tiger Hunter,62398,62398,0,2017.csv,2017,100%,-
7556,Mifune: The Last Samurai,62279,62279,0,2016.csv,2016,100%,-
7557,Public Speaking,62173,62173,0,2011.csv,2011,100%,-
7558,Proteus,62031,62031,0,2004.csv,2004,100%,-
7559,Trigun: Badlands Rumble 2011 Re-release,62027,62027,0,2011.csv,2011,100%,-
7560,Kites The Remix,61997,41783,20214,2010.csv,2010,67.4%,32.6%
7561,"I, Me aur Main",61863,0,61863,2013.csv,2013,-,100%
7562,Dark Star: HR Gigers Welt,61845,61845,0,2015.csv,2015,100%,-
7563,In a Valley of Violence,61797,61797,0,2016.csv,2016,100%,-
7564,If a Tree Falls: A Story of the Earth Liberation Front,61794,61794,0,2011.csv,2011,100%,-
7565,River Runs Red,61789,9893,51896,2018.csv,2018,16%,84%
7566,Amour Fou,61693,13702,47991,2014.csv,2014,22.2%,77.8%
7567,Quill: The Life of a Guide Dog 2012 Re-release,61674,15674,46000,2012.csv,2012,25.4%,74.6%
7568,Backwards,61465,61465,0,2012.csv,2012,100%,-
7569,Donald Cried,61406,61406,0,2017.csv,2017,100%,-
7570,Here and Now,61271,13892,47379,2018.csv,2018,22.7%,77.3%
7571,Never Goin' Back,61271,61271,0,2018.csv,2018,100%,-
7572,The Seasons In Quincy: Four Portraits of John Berger,61267,28456,32811,2016.csv,2016,46.4%,53.6%
7573,The Outcasts,61250,1455,59795,2017.csv,2017,2.4%,97.6%
7574,The Untamed,61249,27593,33656,2017.csv,2017,45.1%,54.9%
7575,Judy Berlin,61236,61236,0,2000.csv,2000,100%,-
7576,The Mountain,61035,61035,0,2019.csv,2019,100%,-
7577,The Bodyguard 2012 Re-release,61020,61020,0,2012.csv,2012,100%,-
7578,The Sacrifice 2017 Re-release,61018,61018,0,2017.csv,2017,100%,-
7579,Independent Lens: Don't Stop Believin': Everyman's Journey,61018,61018,0,2013.csv,2013,100%,-
7580,Love U... Mr. Kalakaar!,60956,48557,12399,2011.csv,2011,79.7%,20.3%
7581,Chelsea Walls,60902,60902,0,2002.csv,2002,100%,-
7582,The Wicker Man 2013 Re-release,60891,60891,0,2013.csv,2013,100%,-
7583,It's a Disaster,60818,60818,0,2013.csv,2013,100%,-
7584,You I Love,60815,60815,0,2004.csv,2004,100%,-
7585,A Kid Like Jake,60784,58403,2381,2018.csv,2018,96.1%,3.9%
7586,Apprentice,60752,2578,58174,2016.csv,2016,4.2%,95.8%
7587,How to Live Forever,60630,60630,0,2011.csv,2011,100%,-
7588,Viper Club,60607,60607,0,2018.csv,2018,100%,-
7589,Too Late,60438,60438,0,2016.csv,2016,100%,-
7590,Limelight,60335,60335,0,2011.csv,2011,100%,-
7591,Crime After Crime,60291,60291,0,2011.csv,2011,100%,-
7592,Edvard Munch,60244,43539,16705,2005.csv,2005,72.3%,27.7%
7593,Ikiru,60239,60239,0,2002.csv,2002,100%,-
7594,Wetlands 2014 Re-release,60230,59478,752,2014.csv,2014,98.8%,1.2%
7595,Presenting Princess Shaw,60197,60197,0,2016.csv,2016,100%,-
7596,Just One Drop,60078,60078,0,2017.csv,2017,100%,-
7597,Gregory Crewdson: Brief Encounters,60064,60064,0,2012.csv,2012,100%,-
7598,Decoding Annie Parker,60048,48390,11658,2014.csv,2014,80.6%,19.4%
7599,Down and Out with the Dolls,60000,60000,0,2003.csv,2003,100%,-
7600,The Force,59912,59912,0,2017.csv,2017,100%,-
7601,John Fogerty: 50 Year Trip - Live at Red Rocks,59795,59795,0,2019.csv,2019,100%,-
7602,Where Is Kyra?,59717,59717,0,2018.csv,2018,100%,-
7603,Frontera,59696,59696,0,2014.csv,2014,100%,-
7604,Cheap Thrills,59424,59424,0,2014.csv,2014,100%,-
7605,The Extraordinary Voyage,59424,52986,6438,2012.csv,2012,89.2%,10.8%
7606,Sweet Dreams,59403,59403,0,2013.csv,2013,100%,-
7607,Bomb City,59329,59329,0,2018.csv,2018,100%,-
7608,Bang! The Bert Berns Story,59299,59299,0,2017.csv,2017,100%,-
7609,The Young Unknowns,59166,59166,0,2003.csv,2003,100%,-
7610,Digimon Adventure tri. Part 4: Loss,59114,59114,0,2018.csv,2018,100%,-
7611,The Trials of Muhammad Ali,59081,59081,0,2013.csv,2013,100%,-
7612,Screen Door Jesus,59000,59000,0,2005.csv,2005,100%,-
7613,The One I Wrote for You,58872,58872,0,2014.csv,2014,100%,-
7614,Sagrada: The Mystery of Creation 2014 Re-release,58755,58755,0,2014.csv,2014,100%,-
7615,The Conformist 2014 Re-release,58657,58657,0,2014.csv,2014,100%,-
7616,Horn from the Heart: The Paul Butterfield Story,58597,58597,0,2018.csv,2018,100%,-
7617,Putty Hill,58585,49918,8667,2011.csv,2011,85.2%,14.8%
7618,Eyes Without a Face,58565,58565,0,2003.csv,2003,100%,-
7619,Home Delivery: Aapko... Ghar Tak,58499,58499,0,2005.csv,2005,100%,-
7620,Gozu,58202,58202,0,2004.csv,2004,100%,-
7621,Orlando 2010 Re-release,58198,58198,0,2010.csv,2010,100%,-
7622,Cynthia,58177,58177,0,2018.csv,2018,100%,-
7623,Faust,58132,58132,0,2013.csv,2013,100%,-
7624,In Search of Greatness,58090,58090,0,2018.csv,2018,100%,-
7625,Voices of Iraq,57999,57999,0,2004.csv,2004,100%,-
7626,The Boom,57962,57962,0,2017.csv,2017,100%,-
7627,Springtime in a Small Town,57751,43017,14734,2003.csv,2003,74.5%,25.5%
7628,Rififi 2015 Re-release,57749,57749,0,2015.csv,2015,100%,-
7629,Command and Control,57635,57635,0,2016.csv,2016,100%,-
7630,Battleship Potemkin,57620,51198,6422,2011.csv,2011,88.9%,11.1%
7631,Playback,57587,264,57323,2012.csv,2012,0.5%,99.5%
7632,Sold,57527,57527,0,2016.csv,2016,100%,-
7633,Court,57416,22898,34518,2015.csv,2015,39.9%,60.1%
7634,Ramen Heads,57345,57345,0,2018.csv,2018,100%,-
7635,Run & Jump,57189,20061,37128,2014.csv,2014,35.1%,64.9%
7636,Kuch Khatti Kuch Meethi,57188,57188,0,2001.csv,2001,100%,-
7637,Così ridevano,57009,57009,0,2001.csv,2001,100%,-
7638,Wall,56866,14541,42325,2004.csv,2004,25.6%,74.4%
7639,My Joy,56857,6298,50559,2011.csv,2011,11.1%,88.9%
7640,The Battle of Algiers 2016 Re-release,56853,56853,0,2016.csv,2016,100%,-
7641,The Disappearance of My Mother,56821,24951,31870,2019.csv,2019,43.9%,56.1%
7642,Electric Shadows,56809,7129,49680,2005.csv,2005,12.5%,87.5%
7643,Harvard Man,56653,56653,0,2002.csv,2002,100%,-
7644,Farmageddon,56573,56573,0,2011.csv,2011,100%,-
7645,The Two of Us,56558,56558,0,2005.csv,2005,100%,-
7646,Muran,56493,30116,26377,2011.csv,2011,53.3%,46.7%
7647,Beyond the Black Rainbow,56491,56491,0,2012.csv,2012,100%,-
7648,Big Men,56286,56286,0,2014.csv,2014,100%,-
7649,Saving Brinton,56218,56218,0,2017.csv,2017,100%,-
7650,Divan,56214,56214,0,2004.csv,2004,100%,-
7651,Wedding Doll,56196,56196,0,2016.csv,2016,100%,-
7652,Notebook,56166,0,56166,2019.csv,2019,-,100%
7653,False Confessions,56165,29245,26920,2017.csv,2017,52.1%,47.9%
7654,Kart Racer,56146,56146,0,2003.csv,2003,100%,-
7655,Évolution,55985,24770,31215,2016.csv,2016,44.2%,55.8%
7656,Unknown Pleasures,55901,11254,44647,2003.csv,2003,20.1%,79.9%
7657,Terms and Conditions May Apply,55824,55824,0,2013.csv,2013,100%,-
7658,Hellion,55708,55708,0,2014.csv,2014,100%,-
7659,XX,55668,30911,24757,2017.csv,2017,55.5%,44.5%
7660,Holidays,55621,0,55621,2016.csv,2016,-,100%
7661,As Good as Dead,55618,1981,53637,2010.csv,2010,3.6%,96.4%
7662,Finding Joe,55518,55518,0,2011.csv,2011,100%,-
7663,Entertainment,55506,55506,0,2015.csv,2015,100%,-
7664,The Other Side of the Street,55459,55459,0,2005.csv,2005,100%,-
7665,Naam Shabana,55429,0,55429,2017.csv,2017,-,100%
7666,Into Eternity,55366,55366,0,2011.csv,2011,100%,-
7667,Dracula: Pages from a Virgin's Diary,55365,55365,0,2003.csv,2003,100%,-
7668,C.O.G.,55301,55301,0,2013.csv,2013,100%,-
7669,Natural Selection,55282,55282,0,2012.csv,2012,100%,-
7670,The Tracker 2004 Re-release,55188,55188,0,2004.csv,2004,100%,-
7671,Mamma Mia! 2018 Re-release,55168,39601,15567,2018.csv,2018,71.8%,28.2%
7672,American Dream: Detroit,55092,55092,0,2018.csv,2018,100%,-
7673,Le joli mai,55038,55038,0,2013.csv,2013,100%,-
7674,Twenty Two 2017 Re-release,55001,46796,8205,2017.csv,2017,85.1%,14.9%
7675,Zombeavers,54985,14947,40038,2014.csv,2014,27.2%,72.8%
7676,Ciao America,54965,54965,0,2002.csv,2002,100%,-
7677,DAZN Boxing: Canelo Alvarez vs. Rocky Fielding,54916,54916,0,2018.csv,2018,100%,-
7678,Snowmen,54805,54805,0,2011.csv,2011,100%,-
7679,Once in the Life,54780,54780,0,2000.csv,2000,100%,-
7680,Orphans,54754,54754,0,2000.csv,2000,100%,-
7681,The Nature of Existence,54645,54645,0,2010.csv,2010,100%,-
7682,What Our Fathers Did: A Nazi Legacy,54603,40119,14484,2015.csv,2015,73.5%,26.5%
7683,Grand Champion,54579,54579,0,2004.csv,2004,100%,-
7684,The Lottery,54543,54543,0,2010.csv,2010,100%,-
7685,The Harimaya Bridge,54473,54473,0,2010.csv,2010,100%,-
7686,Schizo,54357,54357,0,2005.csv,2005,100%,-
7687,Digimon Adventure tri. Part 6: Future,54324,54324,0,2018.csv,2018,100%,-
7688,Harlan: In the Shadow of Jew Suess,54305,54305,0,2010.csv,2010,100%,-
7689,The Search for General Tso,54275,54275,0,2015.csv,2015,100%,-
7690,Wagner & Me 2012 Re-release,54215,37745,16470,2012.csv,2012,69.6%,30.4%
7691,Line of Duty,54204,54204,0,2013.csv,2013,100%,-
7692,Jungle,54125,54125,0,2000.csv,2000,100%,-
7693,Last Passenger,54110,14806,39304,2014.csv,2014,27.4%,72.6%
7694,Low Down,54051,54051,0,2014.csv,2014,100%,-
7695,A Beautiful Soul,54008,54008,0,2012.csv,2012,100%,-
7696,L.A. Twister,54000,54000,0,2004.csv,2004,100%,-
7697,Surviving Progress,53953,53953,0,2012.csv,2012,100%,-
7698,The Assassin's Code,53940,11218,42722,2018.csv,2018,20.8%,79.2%
7699,The Last Man on the Moon,53881,52482,1399,2016.csv,2016,97.4%,2.6%
7700,The Summer of Sangaile,53843,4480,49363,2015.csv,2015,8.3%,91.7%
7701,At Middleton,53837,53837,0,2014.csv,2014,100%,-
7702,Easy,53825,21589,32236,2004.csv,2004,40.1%,59.9%
7703,Rising from Ashes,53804,38602,15202,2013.csv,2013,71.7%,28.3%
7704,The Heir Apparent: Largo Winch 2011 Re-release,53793,10352,43441,2011.csv,2011,19.2%,80.8%
7705,Down by Love,53780,675,53105,2016.csv,2016,1.3%,98.7%
7706,The Legend of Hallowaiian,53738,451,53287,2018.csv,2018,0.8%,99.2%
7707,The Other F Word,53714,53714,0,2011.csv,2011,100%,-
7708,Leonie 2013 Re-release,53692,53692,0,2013.csv,2013,100%,-
7709,Grass,53503,8084,45419,2018.csv,2018,15.1%,84.9%
7710,God of Vampires,53345,53345,0,2010.csv,2010,100%,-
7711,Boys Life 4: Four Play,53169,53169,0,2003.csv,2003,100%,-
7712,The Great Silence,53074,53074,0,2018.csv,2018,100%,-
7713,Waiting for Happiness,53048,7406,45642,2003.csv,2003,14%,86%
7714,Love Thy Nature,52947,41149,11798,2015.csv,2015,77.7%,22.3%
7715,Ping Pong Summer,52909,52909,0,2014.csv,2014,100%,-
7716,Mia and the Migoo 2010 Re-release,52873,17000,35873,2010.csv,2010,32.2%,67.8%
7717,To Be Takei,52823,52823,0,2014.csv,2014,100%,-
7718,Occupy Unmasked,52768,52768,0,2012.csv,2012,100%,-
7719,!Women Art Revolution,52681,52681,0,2011.csv,2011,100%,-
7720,Salvation Army,52511,3929,48582,2014.csv,2014,7.5%,92.5%
7721,Cropsey,52476,52476,0,2010.csv,2010,100%,-
7722,Hush!,52462,21278,31184,2002.csv,2002,40.6%,59.4%
7723,Going Attractions: The Definitive Story of the American Drive-in Movie,52458,52458,0,2013.csv,2013,100%,-
7724,A Tale of Winter,52431,23268,29163,2014.csv,2014,44.4%,55.6%
7725,Breath Made Visible: Anna Halprin,52387,52387,0,2010.csv,2010,100%,-
7726,Birdboy: The Forgotten Children,52366,38786,13580,2017.csv,2017,74.1%,25.9%
7727,Here and There,52307,27156,25151,2010.csv,2010,51.9%,48.1%
7728,The Human Experience,52296,52296,0,2010.csv,2010,100%,-
7729,In My Skin,52231,31046,21185,2002.csv,2002,59.4%,40.6%
7730,Bigger,52133,46382,5751,2018.csv,2018,89%,11%
7731,Henri-Georges Clouzot's Inferno,52003,25489,26514,2010.csv,2010,49%,51%
7732,Herod's Law,52000,52000,0,2003.csv,2003,100%,-
7733,Hiding and Seeking: Faith and Tolerance After the Holocaust,51936,51936,0,2004.csv,2004,100%,-
7734,Quay,51858,51858,0,2015.csv,2015,100%,-
7735,The Snowman Trek,51743,51743,0,2018.csv,2018,100%,-
7736,Wanda 2018 Re-release,51713,51713,0,2018.csv,2018,100%,-
7737,Midnight Family,51712,42310,9402,2019.csv,2019,81.8%,18.2%
7738,Agnivarsha: The Fire and the Rain,51549,51549,0,2002.csv,2002,100%,-
7739,Tickling Giants,51499,51499,0,2017.csv,2017,100%,-
7740,The Yes Men Are Revolting,51331,50190,1141,2015.csv,2015,97.8%,2.2%
7741,Venus and Serena,51271,51271,0,2013.csv,2013,100%,-
7742,God's Sandbox,51246,51246,0,2005.csv,2005,100%,-
7743,God Loves Uganda,51229,51229,0,2013.csv,2013,100%,-
7744,A Matter of Taste,51148,10720,40428,2001.csv,2001,21%,79%
7745,An Invisible Sign,51138,1279,49859,2011.csv,2011,2.5%,97.5%
7746,Da wan,51059,820,50239,2002.csv,2002,1.6%,98.4%
7747,Wasabi Tuna 2005 Re-release,51036,51036,0,2005.csv,2005,100%,-
7748,The Unknowns,51035,51035,0,2016.csv,2016,100%,-
7749,The Good Doctor,51017,5206,45811,2012.csv,2012,10.2%,89.8%
7750,As I Open My Eyes,50721,30989,19732,2016.csv,2016,61.1%,38.9%
7751,Long Night's Journey Into Day,50715,50715,0,2000.csv,2000,100%,-
7752,Asambhav,50611,19504,31107,2004.csv,2004,38.5%,61.5%
7753,Keep Quiet,50451,50451,0,2017.csv,2017,100%,-
7754,Clinton Road,50400,50400,0,2019.csv,2019,100%,-
7755,Wake in Fright 2012 Re-release,50394,50394,0,2012.csv,2012,100%,-
7756,Midnight Traveler,50336,41265,9071,2019.csv,2019,82%,18%
7757,The Fitzgerald Family Christmas,50292,50292,0,2012.csv,2012,100%,-
7758,The Royal Wedding: Prince Harry and Meghan Markle,50264,50264,0,2018.csv,2018,100%,-
7759,The Warrior 2005 Re-release,50257,50257,0,2005.csv,2005,100%,-
7760,The Retrieval,50257,50257,0,2014.csv,2014,100%,-
7761,You'll Get Over It,50256,50256,0,2004.csv,2004,100%,-
7762,In Order of Disappearance 2016 Re-release,50251,50251,0,2016.csv,2016,100%,-
7763,A Family Affair,50075,50075,0,2003.csv,2003,100%,-
7764,Quest,50022,47807,2215,2017.csv,2017,95.6%,4.4%
7765,The Discoverers,50020,50020,0,2014.csv,2014,100%,-
7766,AKA,49988,49988,0,2003.csv,2003,100%,-
7767,Spring,49970,49970,0,2015.csv,2015,100%,-
7768,On the Outs,49940,49940,0,2005.csv,2005,100%,-
7769,How to Kill Your Neighbor's Dog,49894,49894,0,2002.csv,2002,100%,-
7770,Free Trip to Egypt,49693,49693,0,2019.csv,2019,100%,-
7771,The Fantasticks,49666,49666,0,2000.csv,2000,100%,-
7772,NOW: In the Wings on a World Stage,49591,49591,0,2014.csv,2014,100%,-
7773,Red Herring,49480,49480,0,2015.csv,2015,100%,-
7774,GasLand,49428,30846,18582,2010.csv,2010,62.4%,37.6%
7775,Eureka,49388,49388,0,2001.csv,2001,100%,-
7776,Jumanji/Jumanji: Welcome to the Jungle 2018 NCM Fathom Event,49381,49381,0,2018.csv,2018,100%,-
7777,Shirin in Love,49254,49254,0,2014.csv,2014,100%,-
7778,Confusion of Genders 2003 Re-release,49237,49237,0,2003.csv,2003,100%,-
7779,The Amati Girls,49136,49136,0,2001.csv,2001,100%,-
7780,Bonsai,49128,21267,27861,2012.csv,2012,43.3%,56.7%
7781,Assisted Living,49048,49048,0,2005.csv,2005,100%,-
7782,Hal,49045,48698,347,2018.csv,2018,99.3%,0.7%
7783,Raging Bull 25th Anniversary,49034,49034,0,2005.csv,2005,100%,-
7784,Orgasm Inc.,49001,49001,0,2011.csv,2011,100%,-
7785,Chocolate: Deep Dark Secrets,49000,49000,0,2005.csv,2005,100%,-
7786,Lucky Them,48995,48995,0,2014.csv,2014,100%,-
7787,Bolivar Is Me,48911,48911,0,2002.csv,2002,100%,-
7788,The Internet's Own Boy: The Story of Aaron Swartz,48911,48911,0,2014.csv,2014,100%,-
7789,The Seven Five,48869,48869,0,2015.csv,2015,100%,-
7790,The Bounty Killer,48815,48815,0,2019.csv,2019,100%,-
7791,A Thousand Clouds of Peace,48782,48782,0,2004.csv,2004,100%,-
7792,The Citizen,48767,24296,24471,2013.csv,2013,49.8%,50.2%
7793,A Birder's Guide to Everything,48713,48713,0,2014.csv,2014,100%,-
7794,American Mustang,48700,48700,0,2014.csv,2014,100%,-
7795,Tales from Earthsea 2010 Re-release,48658,48658,0,2010.csv,2010,100%,-
7796,The China Hustle,48650,48650,0,2018.csv,2018,100%,-
7797,Person to Person,48499,48499,0,2017.csv,2017,100%,-
7798,Alléluia,48426,6334,42092,2014.csv,2014,13.1%,86.9%
7799,Boogie Woogie,48411,2618,45793,2010.csv,2010,5.4%,94.6%
7800,"Lebanon, Pa.",48381,48381,0,2011.csv,2011,100%,-
7801,Waydowntown,48333,48333,0,2000.csv,2000,100%,-
7802,Ceremony,48174,22270,25904,2011.csv,2011,46.2%,53.8%
7803,The Forbidden Room,48082,34404,13678,2015.csv,2015,71.6%,28.4%
7804,Interview with the Assassin,48058,48058,0,2002.csv,2002,100%,-
7805,L!fe Happens,48041,30905,17136,2012.csv,2012,64.3%,35.7%
7806,Un Flic,48040,48040,0,2013.csv,2013,100%,-
7807,Blackball 2005 Re-release,48000,48000,0,2005.csv,2005,100%,-
7808,Saving Banksy,47965,47965,0,2017.csv,2017,100%,-
7809,The Queen,47818,47818,0,2019.csv,2019,100%,-
7810,Alphaville,47696,47696,0,2014.csv,2014,100%,-
7811,So B. It,47627,47627,0,2017.csv,2017,100%,-
7812,GMO OMG,47558,47558,0,2013.csv,2013,100%,-
7813,350 Days - Legends. Champions. Survivors,47526,47526,0,2018.csv,2018,100%,-
7814,Entre les Bras,47439,47439,0,2012.csv,2012,100%,-
7815,Twist,47370,47370,0,2004.csv,2004,100%,-
7816,Alabama Moon,47305,47305,0,2011.csv,2011,100%,-
7817,Daughters of the Dust 2016 Re-release,47287,40986,6301,2016.csv,2016,86.7%,13.3%
7818,The Raft,47269,39678,7591,2019.csv,2019,83.9%,16.1%
7819,Every Man for Himself,47262,47262,0,2010.csv,2010,100%,-
7820,Never Been Thawed,47219,47219,0,2005.csv,2005,100%,-
7821,Went the Day Well?,47214,47214,0,2011.csv,2011,100%,-
7822,The Goebbels Experiment,47211,47211,0,2005.csv,2005,100%,-
7823,Ivansxtc,47027,47027,0,2002.csv,2002,100%,-
7824,Diary of a Country Priest,47000,47000,0,2011.csv,2011,100%,-
7825,A Master Builder,46874,46874,0,2014.csv,2014,100%,-
7826,78/52: Hitchcock's Shower Scene,46838,37664,9174,2017.csv,2017,80.4%,19.6%
7827,"Connected: An Autoblogography About Love, Death & Technology",46782,46782,0,2011.csv,2011,100%,-
7828,Tropical Malady,46750,46750,0,2005.csv,2005,100%,-
7829,The Woodmans,46623,46623,0,2011.csv,2011,100%,-
7830,Ca$h,46488,46488,0,2010.csv,2010,100%,-
7831,Shanghai 2015 Re-release,46425,46425,0,2015.csv,2015,100%,-
7832,Etoiles: Dancers of the Paris Opera Ballet,46412,46412,0,2002.csv,2002,100%,-
7833,Patience (After Sebald),46410,15941,30469,2012.csv,2012,34.3%,65.7%
7834,Mediterranea,46392,22076,24316,2015.csv,2015,47.6%,52.4%
7835,William S. Burroughs: A Man Within,46380,46380,0,2010.csv,2010,100%,-
7836,New Best Friend,46375,46375,0,2002.csv,2002,100%,-
7837,The Tunnel 2005 Re-release,46296,46296,0,2005.csv,2005,100%,-
7838,Greedy Lying Bastards,46121,45000,1121,2012.csv,2012,97.6%,2.4%
7839,Ballplayer: Pelotero,46109,46109,0,2012.csv,2012,100%,-
7840,Panique,46041,46041,0,2017.csv,2017,100%,-
7841,Every Day,46029,46029,0,2011.csv,2011,100%,-
7842,Monk with a Camera,45938,45938,0,2014.csv,2014,100%,-
7843,Maurice 2017 Re-release,45926,45926,0,2017.csv,2017,100%,-
7844,Ellie Parker,45726,34410,11316,2005.csv,2005,75.3%,24.7%
7845,High on the Hog,45696,45696,0,2019.csv,2019,100%,-
7846,Eddie: The Sleepwalking Cannibal,45604,1632,43972,2012.csv,2012,3.6%,96.4%
7847,3 Weeks in Yerevan,45536,45536,0,2016.csv,2016,100%,-
7848,An Eye for Beauty,45513,9395,36118,2015.csv,2015,20.6%,79.4%
7849,Straight-Jacket,45497,45497,0,2004.csv,2004,100%,-
7850,Mercury,45429,0,45429,2018.csv,2018,-,100%
7851,Au Hasard Balthazar,45406,45406,0,2003.csv,2003,100%,-
7852,Filmistaan,45406,45406,0,2014.csv,2014,100%,-
7853,Return to the Hiding Place,45405,45405,0,2014.csv,2014,100%,-
7854,Dhadkan,45380,45380,0,2000.csv,2000,100%,-
7855,Sympathy for Mr. Vengeance 2005 Re-release,45289,45289,0,2005.csv,2005,100%,-
7856,Ai Weiwei: The Fake Case,45255,45255,0,2014.csv,2014,100%,-
7857,There's No Place Like Utopia,45254,45254,0,2014.csv,2014,100%,-
7858,Karobaar: The Business of Love,45200,45200,0,2000.csv,2000,100%,-
7859,CornerStore,45176,45176,0,2011.csv,2011,100%,-
7860,American Made Movie,45175,45175,0,2013.csv,2013,100%,-
7861,The Proposal,45149,45149,0,2019.csv,2019,100%,-
7862,Bailey's Billion$,45000,45000,0,2005.csv,2005,100%,-
7863,The Farthest,44921,14773,30148,2017.csv,2017,32.9%,67.1%
7864,Celebration,44898,22557,22341,2019.csv,2019,50.2%,49.8%
7865,The Pruitt-Igoe Myth,44883,44883,0,2012.csv,2012,100%,-
7866,River of Fundament,44840,44840,0,2015.csv,2015,100%,-
7867,Union Square,44830,44830,0,2012.csv,2012,100%,-
7868,That Summer,44659,34556,10103,2018.csv,2018,77.4%,22.6%
7869,The Dog,44581,44581,0,2014.csv,2014,100%,-
7870,The Bride Wore Black,44566,44566,0,2011.csv,2011,100%,-
7871,What Is Democracy?,44536,44536,0,2019.csv,2019,100%,-
7872,"Léon Morin, Priest 2017 Re-release",44511,44511,0,2017.csv,2017,100%,-
7873,Defendor,44462,44462,0,2010.csv,2010,100%,-
7874,William Eggleston in the Real World,44435,44435,0,2005.csv,2005,100%,-
7875,Maze 2019 Re-release,44381,44381,0,2019.csv,2019,100%,-
7876,Such a Long Journey,44364,44364,0,2000.csv,2000,100%,-
7877,Lana's Rain,44287,44287,0,2004.csv,2004,100%,-
7878,Carmine Street Guitars,44253,44253,0,2019.csv,2019,100%,-
7879,Slut in a Good Way,44240,40513,3727,2019.csv,2019,91.6%,8.4%
7880,Nuts!,44230,44230,0,2016.csv,2016,100%,-
7881,Danny Says,44213,44213,0,2016.csv,2016,100%,-
7882,Life of a King,44161,6547,37614,2014.csv,2014,14.8%,85.2%
7883,Hermia & Helena,44156,43152,1004,2017.csv,2017,97.7%,2.3%
7884,Apaharan,44133,44133,0,2005.csv,2005,100%,-
7885,Liyana,44045,44045,0,2018.csv,2018,100%,-
7886,Garry Winogrand: All Things are Photographable,44002,44002,0,2018.csv,2018,100%,-
7887,Granito,43942,43942,0,2011.csv,2011,100%,-
7888,The Circle,43918,43918,0,2001.csv,2001,100%,-
7889,Summer 2011 Re-release,43839,43839,0,2011.csv,2011,100%,-
7890,Animal Factory,43805,43805,0,2000.csv,2000,100%,-
7891,Hitler's Hollywood,43766,43766,0,2018.csv,2018,100%,-
7892,Contempt 2013 Re-release,43763,43763,0,2013.csv,2013,100%,-
7893,Mauvais Sang 2013 Re-release,43758,35176,8582,2013.csv,2013,80.4%,19.6%
7894,The Land,43756,43756,0,2016.csv,2016,100%,-
7895,Bereavement,43712,43712,0,2011.csv,2011,100%,-
7896,Woodshock,43682,42603,1079,2017.csv,2017,97.5%,2.5%
7897,A Grin Without A Cat,43616,43616,0,2002.csv,2002,100%,-
7898,"February 15, 1839",43595,43595,0,2001.csv,2001,100%,-
7899,Love Etc.,43593,43593,0,2011.csv,2011,100%,-
7900,"OC87: The Obsessive Compulsive, Major Depression, Bipolar, Asperger's Movie",43583,43583,0,2012.csv,2012,100%,-
7901,The Graduate 45th Anniversary Reunion,43466,43466,0,2012.csv,2012,100%,-
7902,If You Build It,43393,43393,0,2014.csv,2014,100%,-
7903,The Empire of Corpses,43320,0,43320,2016.csv,2016,-,100%
7904,Next Goal Wins,43089,43089,0,2014.csv,2014,100%,-
7905,3 Backyards,43073,43073,0,2011.csv,2011,100%,-
7906,Jenny's Wedding,42927,4704,38223,2015.csv,2015,11%,89%
7907,Hadh Kar Di Aapne,42914,42914,0,2000.csv,2000,100%,-
7908,Tell Them Who You Are,42908,39075,3833,2005.csv,2005,91.1%,8.9%
7909,Andre Gregory: Before and After Dinner,42892,42892,0,2013.csv,2013,100%,-
7910,First We Take Brooklyn,42812,42812,0,2018.csv,2018,100%,-
7911,Little Lili 2004 Re-release,42628,34634,7994,2004.csv,2004,81.2%,18.8%
7912,Interior. Leather Bar.,42534,42534,0,2014.csv,2014,100%,-
7913,Bolivia,42451,33098,9353,2002.csv,2002,78%,22%
7914,Last Call at the Oasis,42423,42423,0,2012.csv,2012,100%,-
7915,Fixing the Future,42393,42393,0,2012.csv,2012,100%,-
7916,Secret Lives: Hidden Children and Their Rescuers During WWII,42390,42390,0,2003.csv,2003,100%,-
7917,Closet Monster,42360,42166,194,2016.csv,2016,99.5%,0.5%
7918,The Oath,42273,42273,0,2010.csv,2010,100%,-
7919,Girlhood,42213,37977,4236,2003.csv,2003,90%,10%
7920,Death of a Dynasty,42108,42108,0,2005.csv,2005,100%,-
7921,Down for Life,41914,41914,0,2011.csv,2011,100%,-
7922,In Pursuit of Silence,41913,29834,12079,2016.csv,2016,71.2%,28.8%
7923,Golden Exits,41888,41888,0,2018.csv,2018,100%,-
7924,The Nightmare,41853,28281,13572,2015.csv,2015,67.6%,32.4%
7925,On the Bowery,41802,41802,0,2010.csv,2010,100%,-
7926,Blackboards,41772,23520,18252,2002.csv,2002,56.3%,43.7%
7927,The Road Within,41760,0,41760,2015.csv,2015,-,100%
7928,Adored,41703,41703,0,2004.csv,2004,100%,-
7929,Union,41656,41656,0,2019.csv,2019,100%,-
7930,Kalakalappu,41624,30949,10675,2012.csv,2012,74.4%,25.6%
7931,Death of a Superhero,41575,607,40968,2012.csv,2012,1.5%,98.5%
7932,The Settlers,41562,41562,0,2017.csv,2017,100%,-
7933,Holla II,41537,41537,0,2013.csv,2013,100%,-
7934,My Mother's Smile 2005 Re-release,41432,41432,0,2005.csv,2005,100%,-
7935,Censored Voices,41260,41260,0,2015.csv,2015,100%,-
7936,Steve McQueen: The Man & Le Mans,41203,6843,34360,2015.csv,2015,16.6%,83.4%
7937,Vlad,41176,0,41176,2004.csv,2004,-,100%
7938,The Comedy,41113,41113,0,2012.csv,2012,100%,-
7939,Karl Marx City,41072,41072,0,2017.csv,2017,100%,-
7940,Blue Iguana,41050,0,41050,2018.csv,2018,-,100%
7941,The Myth of the American Sleepover,41045,41045,0,2011.csv,2011,100%,-
7942,Fat Kid Rules the World,41000,41000,0,2012.csv,2012,100%,-
7943,Why Don't You Just Die!,40995,0,40995,2019.csv,2019,-,100%
7944,Hell and Back Again,40949,40634,315,2011.csv,2011,99.2%,0.8%
7945,Tom Dowd & the Language of Music,40919,40919,0,2004.csv,2004,100%,-
7946,Simon Magus,40861,40861,0,2001.csv,2001,100%,-
7947,The Intruder,40853,40853,0,2005.csv,2005,100%,-
7948,Hate Crime,40758,40758,0,2005.csv,2005,100%,-
7949,Found Memories,40729,10575,30154,2012.csv,2012,26%,74%
7950,Shikari,40712,40712,0,2000.csv,2000,100%,-
7951,Language of a Broken Heart,40645,40645,0,2013.csv,2013,100%,-
7952,Mercedes Sosa: The Voice of Latin America,40643,2648,37995,2013.csv,2013,6.5%,93.5%
7953,Life and Nothing More,40581,24358,16223,2017.csv,2017,60%,40%
7954,Tying the Knot,40576,40576,0,2004.csv,2004,100%,-
7955,My Flesh and Blood,40573,40573,0,2003.csv,2003,100%,-
7956,The FP,40557,40557,0,2012.csv,2012,100%,-
7957,Sex Is Comedy 2004 Re-release,40470,40470,0,2004.csv,2004,100%,-
7958,CBGB,40400,40400,0,2013.csv,2013,100%,-
7959,Terkel in Trouble 2010 Re-release,40385,40385,0,2010.csv,2010,100%,-
7960,Committed,40361,40361,0,2000.csv,2000,100%,-
7961,Zizek!,40331,20177,20154,2005.csv,2005,50%,50%
7962,Of Mind and Music,40322,15073,25249,2016.csv,2016,37.4%,62.6%
7963,Paan Singh Tomar,40311,40311,0,2012.csv,2012,100%,-
7964,The Red Baron 2010 Re-release,40239,37189,3050,2010.csv,2010,92.4%,7.6%
7965,Teenage,40169,40169,0,2014.csv,2014,100%,-
7966,On Her Shoulders,40145,28288,11857,2018.csv,2018,70.5%,29.5%
7967,Aniara,40124,40124,0,2019.csv,2019,100%,-
7968,Margaret Cho: Assassin,40123,40123,0,2005.csv,2005,100%,-
7969,Addiction Incorporated,40106,40106,0,2011.csv,2011,100%,-
7970,Humor Me,40099,40099,0,2018.csv,2018,100%,-
7971,Unrest,40081,40081,0,2017.csv,2017,100%,-
7972,Ghost River 2004 Re-release,40029,40029,0,2004.csv,2004,100%,-
7973,Louder Than a Bomb,40000,40000,0,2011.csv,2011,100%,-
7974,Submission,39985,39985,0,2018.csv,2018,100%,-
7975,Is That a Gun in Your Pocket?,39928,39928,0,2016.csv,2016,100%,-
7976,Justice,39895,39895,0,2004.csv,2004,100%,-
7977,The Short Game,39819,39819,0,2013.csv,2013,100%,-
7978,Plot for Peace,39811,7051,32760,2013.csv,2013,17.7%,82.3%
7979,Freeze Frame,39663,1100,38563,2004.csv,2004,2.8%,97.2%
7980,Port of Shadows,39623,27389,12234,2012.csv,2012,69.1%,30.9%
7981,An Elephant Sitting Still,39599,32556,7043,2018.csv,2018,82.2%,17.8%
7982,The Homeless Billionaire,39493,39493,0,2016.csv,2016,100%,-
7983,Power Trip,39359,39359,0,2003.csv,2003,100%,-
7984,Prophet's Prey,39347,39347,0,2015.csv,2015,100%,-
7985,Child of God,39324,39324,0,2014.csv,2014,100%,-
7986,"3½ Minutes, Ten Bullets",39263,30407,8856,2015.csv,2015,77.4%,22.6%
7987,La Notte,39236,39236,0,2016.csv,2016,100%,-
7988,Where Soldiers Come From,39201,39201,0,2011.csv,2011,100%,-
7989,How to Make Money Selling Drugs,39192,39192,0,2013.csv,2013,100%,-
7990,I Do Not Care If We Go Down in History as Barbarians,39171,11307,27864,2018.csv,2018,28.9%,71.1%
7991,The Expedition to the End of the World,39115,39115,0,2014.csv,2014,100%,-
7992,Zilla and Zoe,39003,39003,0,2019.csv,2019,100%,-
7993,I Used to Be Darker,38974,22214,16760,2013.csv,2013,57%,43%
7994,Herb & Dorothy 50X50,38933,38933,0,2013.csv,2013,100%,-
7995,Shed of the Dead,38901,38901,0,2019.csv,2019,100%,-
7996,The Son of Joseph,38774,30588,8186,2016.csv,2016,78.9%,21.1%
7997,Restored Me,38745,38745,0,2016.csv,2016,100%,-
7998,Bluebeard,38696,33490,5206,2010.csv,2010,86.5%,13.5%
7999,Paul Williams Still Alive,38691,38691,0,2012.csv,2012,100%,-
8000,Catching the Sun,38613,38613,0,2016.csv,2016,100%,-
8001,A Rumor of Angels,38610,38610,0,2002.csv,2002,100%,-
8002,The Year of the Yao,38585,35591,2994,2005.csv,2005,92.2%,7.8%
8003,Spa Night,38578,38578,0,2016.csv,2016,100%,-
8004,Troublemakers: The Story of Land Art,38571,29462,9109,2016.csv,2016,76.4%,23.6%
8005,Divide and Conquer: The Story of Roger Ailes,38510,38510,0,2018.csv,2018,100%,-
8006,Death by China,38492,38492,0,2012.csv,2012,100%,-
8007,Multiple Maniacs,38403,33036,5367,2016.csv,2016,86%,14%
8008,Araby,38399,38399,0,2018.csv,2018,100%,-
8009,Batman Forever 2019 Re-release,38387,38014,373,2019.csv,2019,99%,1%
8010,Nine Nation Animation,38382,38382,0,2010.csv,2010,100%,-
8011,The Blackcoat's Daughter,38348,20435,17913,2017.csv,2017,53.3%,46.7%
8012,Belle de Jour 2017 Re-release,38342,26331,12011,2017.csv,2017,68.7%,31.3%
8013,Policeman,38263,11263,27000,2013.csv,2013,29.4%,70.6%
8014,No Intenso Agora,38223,24955,13268,2018.csv,2018,65.3%,34.7%
8015,Shadow Hours,38181,38181,0,2000.csv,2000,100%,-
8016,Germans & Jews,38100,38100,0,2016.csv,2016,100%,-
8017,The Legend of Pale Male,38083,38083,0,2010.csv,2010,100%,-
8018,All About Lily Chou-Chou,38082,26485,11597,2002.csv,2002,69.5%,30.5%
8019,Gray Matter,38034,38034,0,2018.csv,2018,100%,-
8020,Band of Outsiders 2016 Re-release,38004,38004,0,2016.csv,2016,100%,-
8021,Moscow Never Sleeps,38004,25306,12698,2016.csv,2016,66.6%,33.4%
8022,The Crime of Monsieur Lange,38002,36438,1564,2017.csv,2017,95.9%,4.1%
8023,Russian Ark 2013 Re-release,37984,37984,0,2013.csv,2013,100%,-
8024,Bollywood/Hollywood 2003 Re-release,37962,37962,0,2003.csv,2003,100%,-
8025,Adult World,37887,25368,12519,2014.csv,2014,67%,33%
8026,I Am the Blues,37849,37849,0,2017.csv,2017,100%,-
8027,The Heart of Nuba,37788,37788,0,2018.csv,2018,100%,-
8028,Out 1,37743,31539,6204,2015.csv,2015,83.6%,16.4%
8029,Mumia: Long Distance Revolutionary,37731,37731,0,2013.csv,2013,100%,-
8030,Millennium Actress,37641,37641,0,2003.csv,2003,100%,-
8031,Krystal,37516,37516,0,2018.csv,2018,100%,-
8032,News from Planet Mars,37507,310,37197,2016.csv,2016,0.8%,99.2%
8033,Incident at Loch Ness,37493,37493,0,2004.csv,2004,100%,-
8034,Big Sur,37466,37466,0,2013.csv,2013,100%,-
8035,Match 2015 Re-release,37285,37285,0,2015.csv,2015,100%,-
8036,Memory: The Origins of Alien,37272,31378,5894,2019.csv,2019,84.2%,15.8%
8037,Savannah,37240,37240,0,2013.csv,2013,100%,-
8038,This Thing of Ours,37227,37227,0,2003.csv,2003,100%,-
8039,What You Gonna Do When the World's on Fire?,37195,4672,32523,2019.csv,2019,12.6%,87.4%
8040,Benjamin Smoke,37111,37111,0,2000.csv,2000,100%,-
8041,Small Group,37058,37058,0,2018.csv,2018,100%,-
8042,24 Frames,37045,34482,2563,2018.csv,2018,93.1%,6.9%
8043,The Quiet One,37010,37010,0,2019.csv,2019,100%,-
8044,Pavilion of Women,36992,36992,0,2001.csv,2001,100%,-
8045,Children of Paradise 2012 Re-release,36986,36986,0,2012.csv,2012,100%,-
8046,Grey Gardens,36923,36923,0,2015.csv,2015,100%,-
8047,Kurukshetra,36890,36890,0,2000.csv,2000,100%,-
8048,Trust Fund,36885,36885,0,2016.csv,2016,100%,-
8049,The Death of Dick Long,36856,36856,0,2019.csv,2019,100%,-
8050,Sister Code,36676,36676,0,2015.csv,2015,100%,-
8051,Mind Game,36613,36613,0,2018.csv,2018,100%,-
8052,Bending the Arc,36586,21907,14679,2017.csv,2017,59.9%,40.1%
8053,Yoga Hosers,36585,0,36585,2016.csv,2016,-,100%
8054,Hit So Hard,36576,34025,2551,2012.csv,2012,93%,7%
8055,For Those Who Don't Read Me,36506,36506,0,2018.csv,2018,100%,-
8056,Cherry,36465,11362,25103,2010.csv,2010,31.2%,68.8%
8057,The Servant,36463,36463,0,2013.csv,2013,100%,-
8058,The Umbrellas of Cherbourg,36432,28030,8402,2004.csv,2004,76.9%,23.1%
8059,From Here to Eternity,36416,36416,0,2003.csv,2003,100%,-
8060,Unexpected,36402,23986,12416,2015.csv,2015,65.9%,34.1%
8061,How to Let Go of the World: and Love All the Things Climate Can't Change,36386,36386,0,2016.csv,2016,100%,-
8062,Welcome to Leith,36380,36010,370,2015.csv,2015,99%,1%
8063,Mansome,36280,36280,0,2012.csv,2012,100%,-
8064,Our Time,36240,14777,21463,2019.csv,2019,40.8%,59.2%
8065,Loosies,36145,3519,32626,2012.csv,2012,9.7%,90.3%
8066,Touchy Feely,36128,36128,0,2013.csv,2013,100%,-
8067,Dirty Love,36099,36099,0,2005.csv,2005,100%,-
8068,Le Corbeau,36089,36089,0,2018.csv,2018,100%,-
8069,Jiminy Glick in Lalawood,36039,36039,0,2005.csv,2005,100%,-
8070,Brimstone & Glory,36036,32059,3977,2017.csv,2017,89%,11%
8071,"Kill Me, Deadly",36027,36027,0,2016.csv,2016,100%,-
8072,Not Cool,36026,36026,0,2014.csv,2014,100%,-
8073,Almost Friends,35842,1481,34361,2017.csv,2017,4.1%,95.9%
8074,The House of Tomorrow,35821,35821,0,2018.csv,2018,100%,-
8075,Bangkok Revenge,35784,35784,0,2012.csv,2012,100%,-
8076,The Road Movie,35757,35757,0,2018.csv,2018,100%,-
8077,Good Manners,35714,31177,4537,2018.csv,2018,87.3%,12.7%
8078,Paul Goodman Changed My Life,35671,35671,0,2011.csv,2011,100%,-
8079,Far Out Isn't Far Enough: The Tomi Ungerer Story,35647,35647,0,2013.csv,2013,100%,-
8080,After Freedom,35639,35639,0,2004.csv,2004,100%,-
8081,Loro,35613,35613,0,2019.csv,2019,100%,-
8082,M 2013 Re-release,35566,35566,0,2013.csv,2013,100%,-
8083,Guy and Madeline on a Park Bench,35556,35556,0,2010.csv,2010,100%,-
8084,Finders Keepers,35555,35555,0,2015.csv,2015,100%,-
8085,The Event,35554,35554,0,2003.csv,2003,100%,-
8086,PGS: Intuition Is Your Personal Guidance System,35423,35423,0,2018.csv,2018,100%,-
8087,Kinyarwanda,35412,35412,0,2011.csv,2011,100%,-
8088,Max and the Junkmen,35387,35387,0,2012.csv,2012,100%,-
8089,Le Jour Se Leve,35321,35321,0,2014.csv,2014,100%,-
8090,Growing Up Smith,35312,35312,0,2017.csv,2017,100%,-
8091,Der Anständige,35282,21327,13955,2014.csv,2014,60.4%,39.6%
8092,Underdogs,35271,35271,0,2013.csv,2013,100%,-
8093,Rat Film,35195,35195,0,2017.csv,2017,100%,-
8094,Ága,35178,35178,0,2019.csv,2019,100%,-
8095,That Man from Rio,35144,35144,0,2014.csv,2014,100%,-
8096,"Goodbye, Dragon Inn",35120,35120,0,2004.csv,2004,100%,-
8097,When Harry Tries to Marry,35100,35100,0,2011.csv,2011,100%,-
8098,The Girl,35048,35048,0,2013.csv,2013,100%,-
8099,Hotel,34971,29813,5158,2003.csv,2003,85.3%,14.7%
8100,A Decade Under the Influence,34837,34837,0,2003.csv,2003,100%,-
8101,Campfire,34835,34835,0,2005.csv,2005,100%,-
8102,Beneath the Harvest Sky,34768,34768,0,2014.csv,2014,100%,-
8103,This Ain't No Mouse Music,34754,34754,0,2014.csv,2014,100%,-
8104,Comic-Con Episode IV: A Fan's Hope,34665,34665,0,2012.csv,2012,100%,-
8105,The Old Dark House,34649,25678,8971,2017.csv,2017,74.1%,25.9%
8106,Showboy,34646,34646,0,2004.csv,2004,100%,-
8107,Sophie and the Rising Sun,34630,34630,0,2017.csv,2017,100%,-
8108,Le Trou,34588,34588,0,2017.csv,2017,100%,-
8109,Orchestra of Exiles,34577,34577,0,2012.csv,2012,100%,-
8110,Rakuen Tsuiho: Expelled from Paradise,34510,34510,0,2014.csv,2014,100%,-
8111,Cosmos,34393,25856,8537,2015.csv,2015,75.2%,24.8%
8112,Pierrot le Fou 2015 Re-release,34371,34371,0,2015.csv,2015,100%,-
8113,Holy Hell,34366,34366,0,2018.csv,2018,100%,-
8114,Off the Rails,34249,34249,0,2016.csv,2016,100%,-
8115,Rocks in My Pockets,34236,34236,0,2014.csv,2014,100%,-
8116,Martin & Orloff,34222,34222,0,2003.csv,2003,100%,-
8117,Just Like a Woman,34206,11403,22803,2013.csv,2013,33.3%,66.7%
8118,Dave Made a Maze,34117,34117,0,2017.csv,2017,100%,-
8119,Beautiful Darling,34096,34096,0,2011.csv,2011,100%,-
8120,Kilo Two Bravo,34017,7891,26126,2015.csv,2015,23.2%,76.8%
8121,Bert Stern: Original Madman,34005,34005,0,2013.csv,2013,100%,-
8122,Maui,33953,33953,0,2018.csv,2018,100%,-
8123,Killer Unicorn,33901,33901,0,2019.csv,2019,100%,-
8124,Signs & Wonders,33842,33842,0,2001.csv,2001,100%,-
8125,Moonlight Sonata: Deafness in Three Movements,33823,33823,0,2019.csv,2019,100%,-
8126,It Felt Like Love,33817,33817,0,2014.csv,2014,100%,-
8127,Closed Curtain,33735,28098,5637,2014.csv,2014,83.3%,16.7%
8128,Below Her Mouth,33673,0,33673,2017.csv,2017,-,100%
8129,The Turandot Project,33504,33504,0,2001.csv,2001,100%,-
8130,Making the Boys,33443,33443,0,2011.csv,2011,100%,-
8131,The Winding Stream,33420,33420,0,2015.csv,2015,100%,-
8132,Final Girl,33411,0,33411,2015.csv,2015,-,100%
8133,"Distant Voices, Still Lives 2018 Re-release",33301,5234,28067,2018.csv,2018,15.7%,84.3%
8134,Running from Crazy,33300,33300,0,2013.csv,2013,100%,-
8135,Life: A User's Manual,33236,33236,0,2001.csv,2001,100%,-
8136,Daddy Longlegs,33217,21766,11451,2010.csv,2010,65.5%,34.5%
8137,Wasted! The Story of Food Waste,33211,33211,0,2017.csv,2017,100%,-
8138,Love & Taxes,33150,33150,0,2017.csv,2017,100%,-
8139,American Teacher,33144,33144,0,2011.csv,2011,100%,-
8140,Super Dark Times,33109,33109,0,2017.csv,2017,100%,-
8141,Dislecksia: The Movie,33066,33066,0,2013.csv,2013,100%,-
8142,Meet Monica Velour,33042,33042,0,2011.csv,2011,100%,-
8143,Ahead of Time: The Extraordinary Journey of Ruth Gruber,33024,33024,0,2010.csv,2010,100%,-
8144,Albatross,32992,0,32992,2011.csv,2011,-,100%
8145,Being Charlie,32964,30400,2564,2016.csv,2016,92.2%,7.8%
8146,Spoken Word,32961,32961,0,2010.csv,2010,100%,-
8147,The Intervention,32919,32919,0,2016.csv,2016,100%,-
8148,Smile,32833,32833,0,2005.csv,2005,100%,-
8149,No Home Movie,32757,32757,0,2016.csv,2016,100%,-
8150,L'Age d'Or,32712,32712,0,2004.csv,2004,100%,-
8151,The Nun,32659,30245,2414,2018.csv,2018,92.6%,7.4%
8152,Boesman and Lena,32625,32625,0,2000.csv,2000,100%,-
8153,Sollers Point,32608,32608,0,2018.csv,2018,100%,-
8154,The Day I Saw Your Heart 2012 Re-release,32567,3546,29021,2012.csv,2012,10.9%,89.1%
8155,Spettacolo,32494,32494,0,2017.csv,2017,100%,-
8156,Boxing Gym,32476,32476,0,2010.csv,2010,100%,-
8157,Rurouni Kenshin Part I: Origins 2016 Re-release,32445,32445,0,2016.csv,2016,100%,-
8158,An Acceptable Loss,32427,32427,0,2019.csv,2019,100%,-
8159,Brotherhood,32416,19722,12694,2010.csv,2010,60.8%,39.2%
8160,10E,32413,32413,0,2019.csv,2019,100%,-
8161,Beetle Queen Conquers Tokyo,32308,32308,0,2010.csv,2010,100%,-
8162,Living in Emergency,32208,32208,0,2010.csv,2010,100%,-
8163,The Hero of Color City,32188,32188,0,2014.csv,2014,100%,-
8164,Goodland,32140,32140,0,2018.csv,2018,100%,-
8165,The Weekend,32050,32050,0,2000.csv,2000,100%,-
8166,Shooting the Mafia,32042,10881,21161,2019.csv,2019,34%,66%
8167,Desolation Center,32016,32016,0,2019.csv,2019,100%,-
8168,Last Life in the Universe,32014,32014,0,2004.csv,2004,100%,-
8169,"Rio, I Love You 2016 Re-release",31982,31982,0,2016.csv,2016,100%,-
8170,Moynihan,31970,31970,0,2018.csv,2018,100%,-
8171,District of Corruption,31954,31954,0,2012.csv,2012,100%,-
8172,Reel Paradise,31918,31918,0,2005.csv,2005,100%,-
8173,Going Shopping,31908,31908,0,2005.csv,2005,100%,-
8174,Amira & Sam,31849,31849,0,2015.csv,2015,100%,-
8175,Paths of the Soul,31747,31747,0,2016.csv,2016,100%,-
8176,180° South,31745,31745,0,2010.csv,2010,100%,-
8177,At Berkeley,31736,31736,0,2013.csv,2013,100%,-
8178,Aurora,31720,5677,26043,2011.csv,2011,17.9%,82.1%
8179,Glowing Eyes,31653,31653,0,2003.csv,2003,100%,-
8180,Gift,31588,31588,0,2019.csv,2019,100%,-
8181,Signature Move,31551,31551,0,2017.csv,2017,100%,-
8182,The Cat Rescuers,31540,31540,0,2019.csv,2019,100%,-
8183,The Passionate Thief,31539,31539,0,2014.csv,2014,100%,-
8184,Musical Chairs,31478,31478,0,2012.csv,2012,100%,-
8185,Celine and Julie Go Boating,31452,31452,0,2012.csv,2012,100%,-
8186,Beyond the Farthest Star,31433,31433,0,2013.csv,2013,100%,-
8187,Here,31428,26743,4685,2012.csv,2012,85.1%,14.9%
8188,Fabled,31425,31425,0,2004.csv,2004,100%,-
8189,Sidemen: Long Road to Glory,31399,31399,0,2017.csv,2017,100%,-
8190,Mudbound,31389,0,31389,2017.csv,2017,-,100%
8191,Don Verdean,31309,31309,0,2015.csv,2015,100%,-
8192,Bootmen,31288,31288,0,2000.csv,2000,100%,-
8193,The Raspberry Reich,31211,31211,0,2004.csv,2004,100%,-
8194,Buddy,31203,31203,0,2019.csv,2019,100%,-
8195,"Hey, Boo: Harper Lee and 'To Kill a Mockingbird'",31135,31135,0,2011.csv,2011,100%,-
8196,Small Town Murder Songs,31133,31133,0,2011.csv,2011,100%,-
8197,7 Witches,31100,31100,0,2017.csv,2017,100%,-
8198,White Irish Drinkers,31056,31056,0,2011.csv,2011,100%,-
8199,Poor Boy,31031,31031,0,2018.csv,2018,100%,-
8200,Chooch,31015,31015,0,2004.csv,2004,100%,-
8201,"2 Autumns, 3 Winters",30985,5819,25166,2014.csv,2014,18.8%,81.2%
8202,The Seventh Fire,30977,30112,865,2016.csv,2016,97.2%,2.8%
8203,Who Is Harry Nilsson (And Why Is Everybody Talkin' About Him?),30975,30975,0,2010.csv,2010,100%,-
8204,Gangster No. 1,30915,30915,0,2002.csv,2002,100%,-
8205,Sans Soleil,30878,30878,0,2003.csv,2003,100%,-
8206,Lamb,30844,14547,16297,2016.csv,2016,47.2%,52.8%
8207,Meet the Fokkens,30810,30810,0,2012.csv,2012,100%,-
8208,Pasolini 2019 Re-release,30757,30757,0,2019.csv,2019,100%,-
8209,Under the Skin of the City,30666,30666,0,2003.csv,2003,100%,-
8210,Documented,30662,30662,0,2014.csv,2014,100%,-
8211,Hide Away,30655,30655,0,2012.csv,2012,100%,-
8212,The Chaperone,30514,0,30514,2011.csv,2011,-,100%
8213,Gang of Roses,30497,30497,0,2003.csv,2003,100%,-
8214,The Boondock Saints,30471,30471,0,2000.csv,2000,100%,-
8215,Los Reyes,30418,30418,0,2019.csv,2019,100%,-
8216,Dealt,30414,30414,0,2017.csv,2017,100%,-
8217,These Birds Walk,30408,30408,0,2013.csv,2013,100%,-
8218,The Take,30380,30380,0,2004.csv,2004,100%,-
8219,"Hare Krishna! The Mantra, the Movement and the Swami Who Started It 2017 Re-release",30380,19278,11102,2017.csv,2017,63.5%,36.5%
8220,Shanghai Red 2010 Re-release,30353,30353,0,2010.csv,2010,100%,-
8221,39 Pounds of Love,30330,28195,2135,2005.csv,2005,93%,7%
8222,Happy Christmas,30312,30312,0,2014.csv,2014,100%,-
8223,No Greater Love,30247,30247,0,2017.csv,2017,100%,-
8224,Down to the Bone,30241,30241,0,2005.csv,2005,100%,-
8225,WMD: Weapons of Mass Deception,30210,30210,0,2004.csv,2004,100%,-
8226,Cold Water,30209,30209,0,2018.csv,2018,100%,-
8227,Army of Shadows 2015 Re-release,30190,30190,0,2015.csv,2015,100%,-
8228,The Times of Harvey Milk,30187,13801,16386,2000.csv,2000,45.7%,54.3%
8229,Runoff,30186,30186,0,2015.csv,2015,100%,-
8230,Paul Taylor Creative Domain,30168,30168,0,2015.csv,2015,100%,-
8231,Southern Baptist Sissies,30160,30160,0,2014.csv,2014,100%,-
8232,In My Sleep,30158,30158,0,2010.csv,2010,100%,-
8233,Lionel Richie at Glastonbury,30123,30123,0,2019.csv,2019,100%,-
8234,Therapy for a Vampire 2016 Re-release,30115,30115,0,2016.csv,2016,100%,-
8235,A Long Way Off,30104,30104,0,2014.csv,2014,100%,-
8236,Manakamana,30029,30029,0,2014.csv,2014,100%,-
8237,Cat Run,30000,30000,0,2011.csv,2011,100%,-
8238,Evidence of a Haunting,29904,29904,0,2011.csv,2011,100%,-
8239,Saint Misbehavin': The Wavy Gravy Movie,29893,29893,0,2010.csv,2010,100%,-
8240,Praise,29874,29874,0,2000.csv,2000,100%,-
8241,Lbs.,29866,29866,0,2010.csv,2010,100%,-
8242,Brother 2012 Re-release,29864,29864,0,2012.csv,2012,100%,-
8243,Long Shot: The Kevin Laue Story 2013 Re-release,29863,29863,0,2013.csv,2013,100%,-
8244,A Fierce Green Fire,29817,29817,0,2013.csv,2013,100%,-
8245,Uncertain,29736,29736,0,2017.csv,2017,100%,-
8246,Multiple Sarcasms,29731,29731,0,2010.csv,2010,100%,-
8247,Yellow Day,29656,29656,0,2014.csv,2014,100%,-
8248,Memories of Underdevelopment 2018 Re-release,29647,29647,0,2018.csv,2018,100%,-
8249,The Perfect Race,29644,29644,0,2019.csv,2019,100%,-
8250,Dead Man's Burden,29634,29634,0,2013.csv,2013,100%,-
8251,The Eyes of My Mother,29539,27099,2440,2016.csv,2016,91.7%,8.3%
8252,Little Fugitive 2013 Re-release,29505,29505,0,2013.csv,2013,100%,-
8253,The Best Democracy Money Can Buy,29500,29500,0,2016.csv,2016,100%,-
8254,The Dog Wedding,29495,29495,0,2016.csv,2016,100%,-
8255,Redemption Road,29384,29384,0,2011.csv,2011,100%,-
8256,Gypsy 83,29367,29367,0,2004.csv,2004,100%,-
8257,Big Girls Don't Cry,29361,1238,28123,2003.csv,2003,4.2%,95.8%
8258,Empathy,29345,29345,0,2004.csv,2004,100%,-
8259,Cousin Jules,29337,29337,0,2013.csv,2013,100%,-
8260,Charm City,29335,29335,0,2018.csv,2018,100%,-
8261,The Topp Twins: Untouchable Girls 2011 Re-release,29316,29316,0,2011.csv,2011,100%,-
8262,Xenia 2015 Re-release,29274,3181,26093,2015.csv,2015,10.9%,89.1%
8263,Lemon,29258,29258,0,2017.csv,2017,100%,-
8264,The Ground Beneath My Feet,29251,29251,0,2019.csv,2019,100%,-
8265,Sinbad: Beyond the Veil of Mists,29245,29245,0,2000.csv,2000,100%,-
8266,Time to Choose,29233,29233,0,2016.csv,2016,100%,-
8267,Naked Fame,29220,29220,0,2005.csv,2005,100%,-
8268,Daybreak,29081,6995,22086,2004.csv,2004,24.1%,75.9%
8269,Fire in the Blood,28994,28994,0,2013.csv,2013,100%,-
8270,Othello,28980,28980,0,2014.csv,2014,100%,-
8271,A Foreign Affair,28909,28909,0,2004.csv,2004,100%,-
8272,Plush,28864,3080,25784,2013.csv,2013,10.7%,89.3%
8273,Teknolust,28811,28811,0,2003.csv,2003,100%,-
8274,Two in the Wave,28808,28808,0,2010.csv,2010,100%,-
8275,Batman & Robin 2019 Re-release,28793,28597,196,2019.csv,2019,99.3%,0.7%
8276,Rebels of the Neon God,28791,28791,0,2015.csv,2015,100%,-
8277,Americons,28782,28782,0,2015.csv,2015,100%,-
8278,Hearts and Minds,28754,28754,0,2004.csv,2004,100%,-
8279,Nénette,28699,18009,10690,2010.csv,2010,62.8%,37.2%
8280,Hitler's Children,28663,28663,0,2012.csv,2012,100%,-
8281,Band of Outsiders,28656,28656,0,2001.csv,2001,100%,-
8282,The Transfiguration,28631,22091,6540,2017.csv,2017,77.2%,22.8%
8283,Garbo: El espía 2011 Re-release,28563,28563,0,2011.csv,2011,100%,-
8284,Restoring Tomorrow,28556,28556,0,2018.csv,2018,100%,-
8285,Stations of the Elevated,28516,28516,0,2014.csv,2014,100%,-
8286,P.S. Your Cat Is Dead!,28454,28454,0,2003.csv,2003,100%,-
8287,Carrie Pilby,28430,18957,9473,2017.csv,2017,66.7%,33.3%
8288,"Rabin, the Last Day",28411,28411,0,2016.csv,2016,100%,-
8289,The Load,28410,28410,0,2019.csv,2019,100%,-
8290,Struck by Lightning,28378,28378,0,2013.csv,2013,100%,-
8291,The Strange Ones,28374,0,28374,2017.csv,2017,-,100%
8292,Southpaw,28365,28365,0,2000.csv,2000,100%,-
8293,North Sea Texas 2012 Re-release,28307,28307,0,2012.csv,2012,100%,-
8294,Arabian Nights: Volume 1 - The Restless One,28245,12260,15985,2015.csv,2015,43.4%,56.6%
8295,"Like Sunday, Like Rain",28208,28208,0,2015.csv,2015,100%,-
8296,7 Chinese Brothers,28180,28180,0,2015.csv,2015,100%,-
8297,Teddy Bears' Picnic,28149,28149,0,2002.csv,2002,100%,-
8298,"South of Heaven, West of Hell",28149,28149,0,2001.csv,2001,100%,-
8299,The Ambassador,28102,28102,0,2012.csv,2012,100%,-
8300,Eternal,28089,28089,0,2005.csv,2005,100%,-
8301,Bikes vs Cars,28072,28072,0,2015.csv,2015,100%,-
8302,Sembene!,28059,28059,0,2015.csv,2015,100%,-
8303,Take Me to the River,28041,28041,0,2016.csv,2016,100%,-
8304,Superstar in a Housedress,28032,28032,0,2004.csv,2004,100%,-
8305,Least Among Saints,28026,28026,0,2012.csv,2012,100%,-
8306,Quai des Orfèvres 2018 Re-release,28013,28013,0,2018.csv,2018,100%,-
8307,The Amendment,27961,27961,0,2018.csv,2018,100%,-
8308,Ribbons,27959,27959,0,2017.csv,2017,100%,-
8309,El Norte 2019 Re-release,27920,27920,0,2019.csv,2019,100%,-
8310,King of the Jungle,27841,27841,0,2001.csv,2001,100%,-
8311,Radio Dreams,27836,27836,0,2017.csv,2017,100%,-
8312,Bauhaus Spirit: 100 Years of Bauhaus,27768,17122,10646,2019.csv,2019,61.7%,38.3%
8313,Simon Killer,27740,27740,0,2013.csv,2013,100%,-
8314,30 Years of Garbage: The Garbage Pail Kids Story,27739,27739,0,2017.csv,2017,100%,-
8315,Senso,27723,27723,0,2018.csv,2018,100%,-
8316,Broadway Idiot,27595,27595,0,2013.csv,2013,100%,-
8317,The King and the Mockingbird 2014 Re-release,27513,27513,0,2014.csv,2014,100%,-
8318,Beyond Vanilla,27396,27396,0,2003.csv,2003,100%,-
8319,Kate Plays Christine,27364,25564,1800,2016.csv,2016,93.4%,6.6%
8320,An Evening with Beverly Luff Linn,27359,6701,20658,2018.csv,2018,24.5%,75.5%
8321,Unlocking the Cage,27284,27284,0,2016.csv,2016,100%,-
8322,Three 2004 Re-release,27256,27256,0,2004.csv,2004,100%,-
8323,Everybody Says I'm Fine!,27225,27225,0,2003.csv,2003,100%,-
8324,Tiger Eyes,27160,27160,0,2013.csv,2013,100%,-
8325,Bronx Gothic,27151,27151,0,2017.csv,2017,100%,-
8326,"Leaving Home, Coming Home: A Portrait of Robert Frank",27073,27073,0,2019.csv,2019,100%,-
8327,Last Weekend,27053,27053,0,2014.csv,2014,100%,-
8328,Clash,27052,27052,0,2011.csv,2011,100%,-
8329,The Last Ride,27000,27000,0,2011.csv,2011,100%,-
8330,Level Five,27000,27000,0,2014.csv,2014,100%,-
8331,Mali Blues,26950,26950,0,2017.csv,2017,100%,-
8332,Cape of Good Hope,26904,26904,0,2005.csv,2005,100%,-
8333,A Monster with a Thousand Heads,26865,24852,2013,2016.csv,2016,92.5%,7.5%
8334,"The Devil, Probably",26816,26816,0,2012.csv,2012,100%,-
8335,Fish Without a Bicycle,26799,26799,0,2004.csv,2004,100%,-
8336,Tap World,26747,26747,0,2015.csv,2015,100%,-
8337,"Massoud, the Afghan 2002 Re-release",26747,26747,0,2002.csv,2002,100%,-
8338,Khiladi 420,26731,26731,0,2000.csv,2000,100%,-
8339,Peace Officer,26632,26632,0,2015.csv,2015,100%,-
8340,"Pink Ribbons, Inc.",26608,26608,0,2012.csv,2012,100%,-
8341,Wrestle,26597,26597,0,2019.csv,2019,100%,-
8342,Milford Graves Full Mantis,26566,26566,0,2018.csv,2018,100%,-
8343,Rosie,26441,6839,19602,2019.csv,2019,25.9%,74.1%
8344,Front Cover,26409,26409,0,2016.csv,2016,100%,-
8345,9 Dead Gay Guys,26377,26377,0,2003.csv,2003,100%,-
8346,At First Light,26338,3292,23046,2018.csv,2018,12.5%,87.5%
8347,Marlina the Murderer in Four Acts,26331,17788,8543,2018.csv,2018,67.6%,32.4%
8348,Donnybrook,26284,26284,0,2019.csv,2019,100%,-
8349,October Country,26185,26185,0,2010.csv,2010,100%,-
8350,The Misandrists,26123,26123,0,2018.csv,2018,100%,-
8351,"Sex, Politics & Cocktails",26087,26087,0,2005.csv,2005,100%,-
8352,They Call us Monsters,26080,26080,0,2017.csv,2017,100%,-
8353,"Lipstick & Dynamite, Piss & Vinegar: The First Ladies of Wrestling",26073,26073,0,2005.csv,2005,100%,-
8354,Maze,26041,26041,0,2001.csv,2001,100%,-
8355,Ridge Runners,26019,26019,0,2018.csv,2018,100%,-
8356,Main Street,26011,2560,23451,2011.csv,2011,9.8%,90.2%
8357,Jet Trash 2018 Re-release,26002,26002,0,2018.csv,2018,100%,-
8358,Black Mother,25919,18762,7157,2018.csv,2018,72.4%,27.6%
8359,Django,25916,25916,0,2012.csv,2012,100%,-
8360,Cowards Bend the Knee,25860,25860,0,2004.csv,2004,100%,-
8361,Women Like Us,25859,25859,0,2017.csv,2017,100%,-
8362,Caesar and Otto's Summer Camp Massacre,25844,25844,0,2011.csv,2011,100%,-
8363,Spriggan,25824,25824,0,2001.csv,2001,100%,-
8364,Elena,25788,25788,0,2014.csv,2014,100%,-
8365,Quitting,25717,18531,7186,2002.csv,2002,72.1%,27.9%
8366,Gurukulam,25651,25651,0,2016.csv,2016,100%,-
8367,Immortality,25648,25648,0,2000.csv,2000,100%,-
8368,Passion Play,25603,3669,21934,2011.csv,2011,14.3%,85.7%
8369,The Exploding Girl,25572,25572,0,2010.csv,2010,100%,-
8370,Banjo,25531,25531,0,2016.csv,2016,100%,-
8371,Waiting for Forever,25517,25517,0,2011.csv,2011,100%,-
8372,Christian Mingle,25480,25480,0,2014.csv,2014,100%,-
8373,Werckmeister Harmonies,25461,25461,0,2001.csv,2001,100%,-
8374,Kill Command,25427,0,25427,2016.csv,2016,-,100%
8375,Nobody Walks,25342,25342,0,2012.csv,2012,100%,-
8376,Maestro,25315,25315,0,2004.csv,2004,100%,-
8377,Rediscover Sautet,25314,25314,0,2015.csv,2015,100%,-
8378,Disturbing the Peace,25287,25287,0,2016.csv,2016,100%,-
8379,In Search of Fellini,25269,12772,12497,2017.csv,2017,50.5%,49.5%
8380,Death of the Virgin,25247,25247,0,2012.csv,2012,100%,-
8381,The Worst Movie Ever!,25206,25206,0,2011.csv,2011,100%,-
8382,Drivers Wanted,25189,25189,0,2005.csv,2005,100%,-
8383,Fresh,25115,25115,0,2010.csv,2010,100%,-
8384,Vazante,25091,23884,1207,2018.csv,2018,95.2%,4.8%
8385,Bonnie & Clyde vs. Dracula,25027,25027,0,2011.csv,2011,100%,-
8386,The Lucky Man,25015,25015,0,2017.csv,2017,100%,-
8387,The Power of Few,25000,25000,0,2013.csv,2013,100%,-
8388,Shadow Glories,24997,24997,0,2001.csv,2001,100%,-
8389,The Isle,24963,20666,4297,2002.csv,2002,82.8%,17.2%
8390,Ugetsu,24959,11197,13762,2017.csv,2017,44.9%,55.1%
8391,R100,24956,24956,0,2015.csv,2015,100%,-
8392,Rana's Wedding,24930,10604,14326,2003.csv,2003,42.5%,57.5%
8393,Naples '44,24863,24620,243,2017.csv,2017,99%,1%
8394,An Elephant's Journey,24844,24844,0,2018.csv,2018,100%,-
8395,Madaari,24822,0,24822,2016.csv,2016,-,100%
8396,Marius/Fanny/César,24787,24787,0,2017.csv,2017,100%,-
8397,Paradise 2017 Re-release,24749,24749,0,2017.csv,2017,100%,-
8398,Cold Comes the Night,24732,16971,7761,2013.csv,2013,68.6%,31.4%
8399,Horses: The Story of Equus,24716,0,24716,2002.csv,2002,-,100%
8400,The Day,24686,20984,3702,2012.csv,2012,85%,15%
8401,Hyènes,24672,24672,0,2019.csv,2019,100%,-
8402,The Departure,24662,24662,0,2017.csv,2017,100%,-
8403,Harvest,24657,24657,0,2011.csv,2011,100%,-
8404,Knuckle,24655,2647,22008,2011.csv,2011,10.7%,89.3%
8405,Eat This New York,24640,24640,0,2004.csv,2004,100%,-
8406,Olvidados 2015 Re-release,24638,24638,0,2015.csv,2015,100%,-
8407,Born to Fly: Elizabeth Streb vs. Gravity,24630,24630,0,2014.csv,2014,100%,-
8408,Bang Rajan 2004 Re-release,24629,24629,0,2004.csv,2004,100%,-
8409,The Aspern Papers,24554,9277,15277,2019.csv,2019,37.8%,62.2%
8410,Immigration Tango,24554,24554,0,2011.csv,2011,100%,-
8411,After,24544,24544,0,2011.csv,2011,100%,-
8412,Graceland,24529,24529,0,2013.csv,2013,100%,-
8413,Too Late to Die Young,24487,16591,7896,2018.csv,2018,67.8%,32.2%
8414,Sudden Fear,24476,24476,0,2016.csv,2016,100%,-
8415,Otter 501,24449,24449,0,2012.csv,2012,100%,-
8416,The Man Who Copied,24391,24391,0,2005.csv,2005,100%,-
8417,Last Days in the Desert,24352,0,24352,2016.csv,2016,-,100%
8418,Honeymoon,24343,9318,15025,2014.csv,2014,38.3%,61.7%
8419,Le Petit Soldat,24296,24296,0,2013.csv,2013,100%,-
8420,Jasmine,24248,24248,0,2017.csv,2017,100%,-
8421,Luster,24137,24137,0,2003.csv,2003,100%,-
8422,Radio Unnameable,24090,24090,0,2012.csv,2012,100%,-
8423,Level Up,24083,1469,22614,2016.csv,2016,6.1%,93.9%
8424,American Storytellers,24082,24082,0,2003.csv,2003,100%,-
8425,Chasing Einstein,24057,24057,0,2019.csv,2019,100%,-
8426,Ranchero,24036,24036,0,2011.csv,2011,100%,-
8427,Beneath the Darkness,23998,0,23998,2012.csv,2012,-,100%
8428,The Fiancé,23986,23986,0,2016.csv,2016,100%,-
8429,Harry Dean Stanton: Partly Fiction,23959,23959,0,2013.csv,2013,100%,-
8430,Almost Holy,23957,21142,2815,2016.csv,2016,88.2%,11.8%
8431,Simple Creature,23918,23918,0,2017.csv,2017,100%,-
8432,Shut Up Little Man! An Audio Misadventure,23901,23901,0,2011.csv,2011,100%,-
8433,Dear Mr. Watterson,23899,23899,0,2013.csv,2013,100%,-
8434,Under The Wire,23897,3429,20468,2018.csv,2018,14.3%,85.7%
8435,Vincent N Roxxy,23896,0,23896,2017.csv,2017,-,100%
8436,Behind the Burly Q,23889,23889,0,2010.csv,2010,100%,-
8437,Emoticon ;),23881,23881,0,2014.csv,2014,100%,-
8438,Happy Valley,23868,23868,0,2014.csv,2014,100%,-
8439,Argentina,23864,14869,8995,2015.csv,2015,62.3%,37.7%
8440,Death House,23833,23833,0,2018.csv,2018,100%,-
8441,Liars Club,23792,23792,0,2002.csv,2002,100%,-
8442,Emmanuel's Gift,23728,23728,0,2005.csv,2005,100%,-
8443,Greenwich Village: Music That Defined a Generation,23701,23701,0,2013.csv,2013,100%,-
8444,Raw Faith,23667,23667,0,2011.csv,2011,100%,-
8445,Southbound,23665,23665,0,2016.csv,2016,100%,-
8446,Good Kids,23627,0,23627,2016.csv,2016,-,100%
8447,Lost Bohemia,23584,23584,0,2011.csv,2011,100%,-
8448,"A Woman, a Part",23562,23562,0,2017.csv,2017,100%,-
8449,The Hill Chris Climbed: The Gridiron Heroes Story,23487,23487,0,2016.csv,2016,100%,-
8450,Letter from Masanjia,23481,23481,0,2018.csv,2018,100%,-
8451,Robert the Bruce,23425,0,23425,2019.csv,2019,-,100%
8452,Believe Me,23419,23419,0,2014.csv,2014,100%,-
8453,Esther Kahn,23371,23371,0,2002.csv,2002,100%,-
8454,Can't Stand Losing You: Surviving the Police,23262,23262,0,2015.csv,2015,100%,-
8455,For Ahkeem,23136,23136,0,2017.csv,2017,100%,-
8456,The Judge,23127,22257,870,2018.csv,2018,96.2%,3.8%
8457,Finding Oscar,23116,23116,0,2017.csv,2017,100%,-
8458,The Iran Job,23115,23115,0,2012.csv,2012,100%,-
8459,S21: The Khmer Rouge Killing Machine,23078,22606,472,2004.csv,2004,98%,2%
8460,The Grace of Jake,23078,23078,0,2017.csv,2017,100%,-
8461,Three Peaks,23069,16216,6853,2018.csv,2018,70.3%,29.7%
8462,History of Jazz: Oxygen for the Ears,23048,23048,0,2014.csv,2014,100%,-
8463,Video Games: The Movie,23043,23043,0,2014.csv,2014,100%,-
8464,Incantato 2004 Re-release,23039,23039,0,2004.csv,2004,100%,-
8465,Goat,23020,23020,0,2016.csv,2016,100%,-
8466,Frankie and Johnny Are Married,22900,22900,0,2004.csv,2004,100%,-
8467,Hellbound?,22887,22887,0,2012.csv,2012,100%,-
8468,Mirzya,22886,0,22886,2016.csv,2016,-,100%
8469,ABC Africa,22881,9075,13806,2001.csv,2001,39.7%,60.3%
8470,Keyhole,22826,22826,0,2012.csv,2012,100%,-
8471,The Long Day Closes,22765,22765,0,2012.csv,2012,100%,-
8472,Carol Channing: Larger Than Life,22740,22740,0,2012.csv,2012,100%,-
8473,The Revisionaries,22664,22664,0,2012.csv,2012,100%,-
8474,Ode to Joy,22594,17303,5291,2019.csv,2019,76.6%,23.4%
8475,Trophy,22553,21439,1114,2017.csv,2017,95.1%,4.9%
8476,The Other City,22539,22539,0,2010.csv,2010,100%,-
8477,The Black Dove,22517,22517,0,2016.csv,2016,100%,-
8478,Casting By,22497,18164,4333,2013.csv,2013,80.7%,19.3%
8479,Middleground,22490,0,22490,2017.csv,2017,-,100%
8480,Happy Tears,22464,22464,0,2010.csv,2010,100%,-
8481,Heavy Trip,22460,10153,12307,2018.csv,2018,45.2%,54.8%
8482,Incendiary,22457,22457,0,2011.csv,2011,100%,-
8483,Realms,22443,147,22296,2017.csv,2017,0.7%,99.3%
8484,Kamikaze 89,22440,22440,0,2016.csv,2016,100%,-
8485,Be Here Now,22424,22424,0,2016.csv,2016,100%,-
8486,Blackmail Boy 2005 Re-release,22393,22393,0,2005.csv,2005,100%,-
8487,Paradise Club,22381,22381,0,2017.csv,2017,100%,-
8488,Picture Me,22369,12008,10361,2010.csv,2010,53.7%,46.3%
8489,Girl Model,22369,21154,1215,2012.csv,2012,94.6%,5.4%
8490,The Painting,22313,21008,1305,2012.csv,2012,94.2%,5.8%
8491,The Atomic Cafe,22293,22293,0,2018.csv,2018,100%,-
8492,Metropolitan 2015 Re-release,22284,22284,0,2015.csv,2015,100%,-
8493,Slow Learners,22272,22272,0,2015.csv,2015,100%,-
8494,Generation Startup,22271,22271,0,2016.csv,2016,100%,-
8495,Reparation,22267,22267,0,2016.csv,2016,100%,-
8496,Winning Formula,22189,22189,0,2018.csv,2018,100%,-
8497,All's Faire in Love,22180,22180,0,2011.csv,2011,100%,-
8498,Princess Cut,22167,22167,0,2015.csv,2015,100%,-
8499,Murder Eleven,22107,22107,0,2013.csv,2013,100%,-
8500,The Garden of Eden,22083,22083,0,2010.csv,2010,100%,-
8501,Losing Control,22081,22081,0,2012.csv,2012,100%,-
8502,And Everything Is Going Fine,22080,22080,0,2010.csv,2010,100%,-
8503,Cuba feliz,22071,22071,0,2002.csv,2002,100%,-
8504,Four Adventures of Reinette and Mirabelle,22039,22039,0,2011.csv,2011,100%,-
8505,Answers to Nothing,22029,22029,0,2011.csv,2011,100%,-
8506,Pet,22003,8004,13999,2016.csv,2016,36.4%,63.6%
8507,The Sound of Silence,21994,20013,1981,2019.csv,2019,91%,9%
8508,Three Dancing Slaves,21888,21888,0,2005.csv,2005,100%,-
8509,The Passion of Joan of Arc,21877,21877,0,2017.csv,2017,100%,-
8510,Deep Gold 3D,21868,12000,9868,2011.csv,2011,54.9%,45.1%
8511,The ABCs of Death,21832,21832,0,2013.csv,2013,100%,-
8512,Animals 2015 Re-release,21821,21821,0,2015.csv,2015,100%,-
8513,Viola,21818,21818,0,2013.csv,2013,100%,-
8514,The Female Brain,21786,21786,0,2018.csv,2018,100%,-
8515,Master of the Flying Guillotine,21779,21779,0,2002.csv,2002,100%,-
8516,Better Than Something: Jay Reatard,21697,21697,0,2012.csv,2012,100%,-
8517,Crazy as Hell,21679,21679,0,2002.csv,2002,100%,-
8518,Dead Awake,21675,11528,10147,2017.csv,2017,53.2%,46.8%
8519,Évocateur: The Morton Downey Jr. Movie,21652,21652,0,2013.csv,2013,100%,-
8520,Toe to Toe,21648,21648,0,2010.csv,2010,100%,-
8521,Sedona,21638,21638,0,2012.csv,2012,100%,-
8522,Blue Jay,21626,21626,0,2016.csv,2016,100%,-
8523,Wicked Witches,21600,21600,0,2019.csv,2019,100%,-
8524,Half the Picture,21589,21589,0,2018.csv,2018,100%,-
8525,Waiting for Lightning,21577,21577,0,2012.csv,2012,100%,-
8526,10 timer til Paradis,21561,16000,5561,2012.csv,2012,74.2%,25.8%
8527,Monogamy,21527,21527,0,2011.csv,2011,100%,-
8528,Slutty Summer,21515,21515,0,2005.csv,2005,100%,-
8529,Thank You for Your Service,21497,21497,0,2016.csv,2016,100%,-
8530,Hagazussa,21487,13253,8234,2018.csv,2018,61.7%,38.3%
8531,Tyrel,21456,21456,0,2018.csv,2018,100%,-
8532,Three of Hearts 2005 Re-release,21429,21429,0,2005.csv,2005,100%,-
8533,Almost Salinas,21419,21419,0,2003.csv,2003,100%,-
8534,Bigger Than the Sky,21398,21398,0,2005.csv,2005,100%,-
8535,The Guys,21366,21366,0,2003.csv,2003,100%,-
8536,Song Of Granite,21349,16182,5167,2017.csv,2017,75.8%,24.2%
8537,Tio Papi,21316,21316,0,2013.csv,2013,100%,-
8538,Memphis,21286,21286,0,2014.csv,2014,100%,-
8539,The Burial Society,21285,21285,0,2004.csv,2004,100%,-
8540,Resurrect Dead: The Mystery of the Toynbee Tiles,21242,21242,0,2011.csv,2011,100%,-
8541,Already Tomorrow in Hong Kong,21206,21206,0,2016.csv,2016,100%,-
8542,Ganja & Hess,21197,21197,0,2018.csv,2018,100%,-
8543,NightLights,21147,21147,0,2014.csv,2014,100%,-
8544,God Knows Where I Am,21135,21135,0,2017.csv,2017,100%,-
8545,The Happys,21108,21108,0,2018.csv,2018,100%,-
8546,Dallas 362,21108,21108,0,2005.csv,2005,100%,-
8547,Massacre on Aisle 12,21106,21106,0,2017.csv,2017,100%,-
8548,A Beginner's Guide to Snuff,21031,21031,0,2017.csv,2017,100%,-
8549,The Sacrifice 2014 Re-release,20945,20945,0,2014.csv,2014,100%,-
8550,Round of Your Life,20941,20941,0,2019.csv,2019,100%,-
8551,Ava,20940,20940,0,2018.csv,2018,100%,-
8552,Man Underground,20907,20907,0,2017.csv,2017,100%,-
8553,Lekar Hum Deewana Dil,20874,20874,0,2014.csv,2014,100%,-
8554,Cameraman: The Life and Work of Jack Cardiff,20840,20840,0,2011.csv,2011,100%,-
8555,Major Dundee,20807,20807,0,2005.csv,2005,100%,-
8556,Time Changer 2016 Re-release,20797,20797,0,2016.csv,2016,100%,-
8557,Did You Wonder Who Fired the Gun?,20765,20765,0,2018.csv,2018,100%,-
8558,All These Sleepless Nights,20762,20762,0,2017.csv,2017,100%,-
8559,For Ellen,20746,12396,8350,2012.csv,2012,59.8%,40.2%
8560,The Ghosts in Our Machine,20709,20709,0,2013.csv,2013,100%,-
8561,Voices in Wartime,20702,20702,0,2005.csv,2005,100%,-
8562,The Great Flood,20694,20694,0,2014.csv,2014,100%,-
8563,The Last Dispatch,20684,20684,0,2005.csv,2005,100%,-
8564,Freak Show,20657,19696,961,2018.csv,2018,95.3%,4.7%
8565,Douchebag,20615,20615,0,2010.csv,2010,100%,-
8566,Our Nixon,20584,20584,0,2013.csv,2013,100%,-
8567,Fidelio: Alice's Odyssey,20571,3580,16991,2015.csv,2015,17.4%,82.6%
8568,Coming Up Roses 2014 Re-release,20567,20567,0,2014.csv,2014,100%,-
8569,Band of Robbers,20555,20555,0,2016.csv,2016,100%,-
8570,The Work,20554,5853,14701,2017.csv,2017,28.5%,71.5%
8571,Ice Dragon: Legend of the Blue Daisies,20549,20549,0,2018.csv,2018,100%,-
8572,This Last Lonely Place,20507,20507,0,2016.csv,2016,100%,-
8573,Consumed,20476,20476,0,2015.csv,2015,100%,-
8574,The Devil and Father Amorth,20449,20449,0,2018.csv,2018,100%,-
8575,Boy Meets Girl,20441,20441,0,2015.csv,2015,100%,-
8576,Burden,20437,18440,1997,2017.csv,2017,90.2%,9.8%
8577,Never,20431,20431,0,2016.csv,2016,100%,-
8578,Orwell Rolls in His Grave,20389,20389,0,2004.csv,2004,100%,-
8579,The Highest Pass,20386,20386,0,2012.csv,2012,100%,-
8580,Ichi the Killer 2017 Re-release,20285,20285,0,2017.csv,2017,100%,-
8581,The Korean,20279,20279,0,2010.csv,2010,100%,-
8582,Double Take,20218,20218,0,2010.csv,2010,100%,-
8583,Izzy Gets the F*ck Across Town,20208,20208,0,2018.csv,2018,100%,-
8584,New World Order,20205,20205,0,2016.csv,2016,100%,-
8585,Jesus Henry Christ,20183,20183,0,2012.csv,2012,100%,-
8586,Shoah,20175,20175,0,2010.csv,2010,100%,-
8587,Chaos,20166,10289,9877,2005.csv,2005,51%,49%
8588,Friends and Romans,20136,20136,0,2015.csv,2015,100%,-
8589,How to Grow a Band,20135,20135,0,2012.csv,2012,100%,-
8590,The Man from Outer Space,20102,20102,0,2017.csv,2017,100%,-
8591,Love Me True,20100,20100,0,2016.csv,2016,100%,-
8592,"Float Like a Butterfly, Sting Like a Bee",20073,20073,0,2003.csv,2003,100%,-
8593,The Past is a Grotesque Animal,20056,20056,0,2014.csv,2014,100%,-
8594,Apocalypsis,20052,20052,0,2018.csv,2018,100%,-
8595,General Magic,20046,20046,0,2019.csv,2019,100%,-
8596,The Gospel of Eureka,20039,20039,0,2019.csv,2019,100%,-
8597,The Deal,20035,0,20035,2005.csv,2005,-,100%
8598,"No Pay, Nudity",20017,20017,0,2016.csv,2016,100%,-
8599,Eight Hours Don't Make a Day,19987,19987,0,2018.csv,2018,100%,-
8600,"One Sings, the Other Doesn't",19919,19919,0,2018.csv,2018,100%,-
8601,Wedding Palace,19908,19908,0,2013.csv,2013,100%,-
8602,Forbidden Games,19889,19889,0,2015.csv,2015,100%,-
8603,Merci Dr Rey!,19867,19867,0,2004.csv,2004,100%,-
8604,Active Measures,19862,19862,0,2018.csv,2018,100%,-
8605,Heat and Dust 2017 Re-release,19856,19856,0,2017.csv,2017,100%,-
8606,"Sia, the Dream of the Python",19830,4662,15168,2002.csv,2002,23.5%,76.5%
8607,The Simian Line,19823,19823,0,2001.csv,2001,100%,-
8608,The Journey,19800,19800,0,2003.csv,2003,100%,-
8609,Wild Canaries,19777,19777,0,2015.csv,2015,100%,-
8610,The Trial,19753,19753,0,2010.csv,2010,100%,-
8611,The Romans,19705,19705,0,2016.csv,2016,100%,-
8612,Trafficked,19698,19698,0,2017.csv,2017,100%,-
8613,Kills On Wheels 2016 Re-release,19680,15898,3782,2016.csv,2016,80.8%,19.2%
8614,Misery Loves Comedy,19634,19634,0,2015.csv,2015,100%,-
8615,Bad Milo,19613,19613,0,2013.csv,2013,100%,-
8616,Art Bastard,19600,19600,0,2016.csv,2016,100%,-
8617,Uzumasa Limelight,19597,19597,0,2014.csv,2014,100%,-
8618,Zoology,19572,0,19572,2016.csv,2016,-,100%
8619,Damascus Cover,19532,0,19532,2018.csv,2018,-,100%
8620,Comet,19530,8623,10907,2014.csv,2014,44.2%,55.8%
8621,Hannah: Buddhism's Untold Journey,19526,396,19130,2016.csv,2016,2%,98%
8622,BOSTON: An American Running Story 2017 Re-release,19499,19499,0,2017.csv,2017,100%,-
8623,Grassroots,19492,12356,7136,2012.csv,2012,63.4%,36.6%
8624,In Over My Head,19482,19482,0,2012.csv,2012,100%,-
8625,Guardian Angel,19480,19480,0,2014.csv,2014,100%,-
8626,A Picture of You,19480,19480,0,2014.csv,2014,100%,-
8627,A Room for Romeo Brass,19478,19478,0,2000.csv,2000,100%,-
8628,Whensday,19463,19463,0,2013.csv,2013,100%,-
8629,Hunter Gatherer,19462,19462,0,2016.csv,2016,100%,-
8630,Skateland,19411,19411,0,2011.csv,2011,100%,-
8631,Garmento,19402,19402,0,2003.csv,2003,100%,-
8632,Mansfield 66/67,19390,17930,1460,2017.csv,2017,92.5%,7.5%
8633,Tchoupitoulas,19375,19375,0,2012.csv,2012,100%,-
8634,Actress,19365,19365,0,2014.csv,2014,100%,-
8635,Peter Brook: The Tightrope,19365,19365,0,2014.csv,2014,100%,-
8636,Watchers of the Sky,19339,19339,0,2014.csv,2014,100%,-
8637,Gabo: The Creation of Gabriel Garcia Marquez,19337,19337,0,2015.csv,2015,100%,-
8638,Melancholian 3 huonetta,19317,19317,0,2005.csv,2005,100%,-
8639,Jackie & Ryan,19305,0,19305,2015.csv,2015,-,100%
8640,Reuniting the Rubins,19288,13569,5719,2011.csv,2011,70.3%,29.7%
8641,Romeos,19248,1081,18167,2011.csv,2011,5.6%,94.4%
8642,Neshoba,19245,19245,0,2010.csv,2010,100%,-
8643,The Manson Family,19140,19140,0,2004.csv,2004,100%,-
8644,The People I've Slept With,19137,19137,0,2010.csv,2010,100%,-
8645,Who We Are Now,19128,19128,0,2018.csv,2018,100%,-
8646,L'important c'est d'aimer,19120,19120,0,2017.csv,2017,100%,-
8647,Revelation: Dawn of Global Government,19107,19107,0,2016.csv,2016,100%,-
8648,Make Believe,19085,19085,0,2011.csv,2011,100%,-
8649,November,19084,19084,0,2018.csv,2018,100%,-
8650,Anything,19037,19037,0,2018.csv,2018,100%,-
8651,Search Engines,19033,19033,0,2016.csv,2016,100%,-
8652,The Challenger,19003,19003,0,2015.csv,2015,100%,-
8653,The Color Wheel,19001,19001,0,2012.csv,2012,100%,-
8654,The Kill Team,18983,18983,0,2014.csv,2014,100%,-
8655,Sophomore,18945,18945,0,2012.csv,2012,100%,-
8656,Devils on the Doorstep,18944,18944,0,2002.csv,2002,100%,-
8657,Smash & Grab: The Story of the Pink Panthers,18938,18938,0,2013.csv,2013,100%,-
8658,Love and a Bullet,18926,18926,0,2002.csv,2002,100%,-
8659,The Deserted Station,18867,18867,0,2004.csv,2004,100%,-
8660,Ktown Cowboys,18863,18863,0,2016.csv,2016,100%,-
8661,Nostalgia,18846,18846,0,2013.csv,2013,100%,-
8662,Frank and Ava,18829,18829,0,2018.csv,2018,100%,-
8663,Test,18823,18823,0,2014.csv,2014,100%,-
8664,A League of Ordinary Gentlemen 2005 Re-release,18807,18807,0,2005.csv,2005,100%,-
8665,Scandalous: The True Story of the National Enquirer,18759,18759,0,2019.csv,2019,100%,-
8666,The Sorcerer and the White Snake 2013 Re-release,18759,18759,0,2013.csv,2013,100%,-
8667,Before Stonewall,18724,18724,0,2019.csv,2019,100%,-
8668,Seoul Searching,18654,18654,0,2016.csv,2016,100%,-
8669,Crime + Punishment,18644,18644,0,2018.csv,2018,100%,-
8670,A Single Shot,18642,18642,0,2013.csv,2013,100%,-
8671,Wish Me Away,18618,18618,0,2012.csv,2012,100%,-
8672,The Return of Martin Guerre 2019 Re-release,18603,18603,0,2019.csv,2019,100%,-
8673,The Pagan King: The Battle of Death,18598,0,18598,2018.csv,2018,-,100%
8674,Bobbi Jene,18579,18579,0,2017.csv,2017,100%,-
8675,La Camioneta: The Journey of One American School Bus,18558,18558,0,2013.csv,2013,100%,-
8676,Let My People Go!,18529,18529,0,2013.csv,2013,100%,-
8677,Allegiance to Broadway,18527,18527,0,2018.csv,2018,100%,-
8678,Mr Ya Miss,18516,18516,0,2005.csv,2005,100%,-
8679,Venus Boyz 2003 Re-release,18515,18515,0,2003.csv,2003,100%,-
8680,Desolation,18490,18490,0,2018.csv,2018,100%,-
8681,All the Rage,18489,18489,0,2017.csv,2017,100%,-
8682,The Ghoul,18459,2032,16427,2017.csv,2017,11%,89%
8683,306 Hollywood,18399,18399,0,2018.csv,2018,100%,-
8684,The Reception,18389,18389,0,2005.csv,2005,100%,-
8685,Oka!,18364,18364,0,2011.csv,2011,100%,-
8686,"Phoenix, Oregon",18356,18356,0,2019.csv,2019,100%,-
8687,"Intent to Destroy: Death, Denial & Depiction 2017 Re-release",18340,18340,0,2017.csv,2017,100%,-
8688,The Channel,18319,18319,0,2016.csv,2016,100%,-
8689,The Life: What's Your Pleasure?,18297,5130,13167,2004.csv,2004,28%,72%
8690,Four Bags Full,18297,18297,0,2013.csv,2013,100%,-
8691,SHOT! The Psycho-Spiritual Mantra of Rock,18295,15157,3138,2017.csv,2017,82.8%,17.2%
8692,Hell House,18279,18279,0,2002.csv,2002,100%,-
8693,Off and Running,18262,18262,0,2010.csv,2010,100%,-
8694,Tosca's Kiss,18236,18236,0,2014.csv,2014,100%,-
8695,Torn,18202,18202,0,2013.csv,2013,100%,-
8696,Marcelino Pan y Vino 2012 Re-release,18193,18193,0,2012.csv,2012,100%,-
8697,Who Is Dayani Cristal?,18190,18190,0,2014.csv,2014,100%,-
8698,The Lion in Winter 2016 Re-release,18177,18177,0,2016.csv,2016,100%,-
8699,Restless,18154,18154,0,2000.csv,2000,100%,-
8700,Coming Through the Rye,18137,18137,0,2016.csv,2016,100%,-
8701,King of Hearts,18130,17646,484,2018.csv,2018,97.3%,2.7%
8702,Peter and the Farm,18123,18123,0,2016.csv,2016,100%,-
8703,Harry Benson: Shoot First,18092,18092,0,2016.csv,2016,100%,-
8704,A Bit of Bad Luck,18089,18089,0,2016.csv,2016,100%,-
8705,Total Recall 2012 Re-release,18081,18081,0,2012.csv,2012,100%,-
8706,Scarlet Diva,18062,18062,0,2002.csv,2002,100%,-
8707,Holy Hell,18051,18051,0,2016.csv,2016,100%,-
8708,On Tour with Pina Bausch,18016,18016,0,2014.csv,2014,100%,-
8709,I Knew Her Well,18010,18010,0,2016.csv,2016,100%,-
8710,Men Go to Battle,18006,18006,0,2016.csv,2016,100%,-
8711,Battle for Brooklyn,18000,18000,0,2011.csv,2011,100%,-
8712,Jamel Shabazz Street Photographer,17992,17992,0,2013.csv,2013,100%,-
8713,Payback,17979,17979,0,2012.csv,2012,100%,-
8714,Cook County,17977,17977,0,2011.csv,2011,100%,-
8715,The King Is Alive,17929,17929,0,2001.csv,2001,100%,-
8716,The Cranes Are Flying,17923,17923,0,2019.csv,2019,100%,-
8717,Great Directors,17921,17921,0,2010.csv,2010,100%,-
8718,Dealin' with Idiots,17909,17909,0,2013.csv,2013,100%,-
8719,Li'l Quinquin,17868,7192,10676,2015.csv,2015,40.3%,59.7%
8720,The Thorn in the Heart,17849,7376,10473,2010.csv,2010,41.3%,58.7%
8721,The Last Shaman,17844,17844,0,2017.csv,2017,100%,-
8722,David,17828,0,17828,2013.csv,2013,-,100%
8723,Batman: Mask of the Phantasm 2018 Re-release,17813,17813,0,2018.csv,2018,100%,-
8724,Purple Butterfly,17790,17790,0,2004.csv,2004,100%,-
8725,Escapes,17778,17778,0,2017.csv,2017,100%,-
8726,Sacred,17740,17740,0,2017.csv,2017,100%,-
8727,Little Birds,17739,17739,0,2012.csv,2012,100%,-
8728,The Other One,17727,17727,0,2015.csv,2015,100%,-
8729,Kelly & Cal,17702,17702,0,2014.csv,2014,100%,-
8730,Bad Grandmas,17688,17688,0,2017.csv,2017,100%,-
8731,The History of Future Folk,17646,17646,0,2013.csv,2013,100%,-
8732,Night at the Golden Eagle,17643,17643,0,2002.csv,2002,100%,-
8733,How He Fell in Love,17575,17575,0,2016.csv,2016,100%,-
8734,"Milwaukee, Minnesota",17528,17528,0,2005.csv,2005,100%,-
8735,The Chronicle of Anna Magdalena Bach,17527,17527,0,2018.csv,2018,100%,-
8736,Sunset Story,17508,17508,0,2005.csv,2005,100%,-
8737,Streit's: Matzo and the American Dream,17506,17506,0,2016.csv,2016,100%,-
8738,Butterfly Girl,17503,17503,0,2015.csv,2015,100%,-
8739,Chained for Life,17431,17431,0,2019.csv,2019,100%,-
8740,A Skin Too Few: The Days of Nick Drake,17384,17384,0,2002.csv,2002,100%,-
8741,Transfixed,17361,17361,0,2004.csv,2004,100%,-
8742,The Law,17351,17351,0,2010.csv,2010,100%,-
8743,"A Bread Factory, Part One/A Bread Factory, Part Two",17325,17325,0,2018.csv,2018,100%,-
8744,Littlerock,17309,17309,0,2011.csv,2011,100%,-
8745,The Homestretch,17306,17306,0,2014.csv,2014,100%,-
8746,Archie's Final Project,17282,17282,0,2011.csv,2011,100%,-
8747,Stand Clear of the Closing Doors,17282,17282,0,2014.csv,2014,100%,-
8748,The Great Water,17257,17257,0,2005.csv,2005,100%,-
8749,Revival,17252,17252,0,2018.csv,2018,100%,-
8750,Speedway Junky,17246,17246,0,2001.csv,2001,100%,-
8751,A Real Young Girl,17245,17245,0,2001.csv,2001,100%,-
8752,Landfill Harmonic,17205,17205,0,2016.csv,2016,100%,-
8753,Food Evolution,17181,17181,0,2017.csv,2017,100%,-
8754,Accident 2014 Re-release,17161,17161,0,2014.csv,2014,100%,-
8755,Pandaemonium,17113,5151,11962,2001.csv,2001,30.1%,69.9%
8756,Le Pont du Nord,17110,17110,0,2013.csv,2013,100%,-
8757,Always Shine,17102,17102,0,2016.csv,2016,100%,-
8758,On the Map,17099,17099,0,2016.csv,2016,100%,-
8759,Grandmaster,17077,17077,0,2012.csv,2012,100%,-
8760,The Understudy,17036,17036,0,2012.csv,2012,100%,-
8761,Goodbye to All That,16986,16986,0,2014.csv,2014,100%,-
8762,The Prophet's Son,16983,16983,0,2012.csv,2012,100%,-
8763,Joseph Pulitzer: Voice of the People,16970,16970,0,2019.csv,2019,100%,-
8764,Eban and Charley,16918,16918,0,2001.csv,2001,100%,-
8765,Carbon Nation,16901,16901,0,2010.csv,2010,100%,-
8766,Return,16886,16124,762,2012.csv,2012,95.5%,4.5%
8767,Hank and Asha,16878,16878,0,2014.csv,2014,100%,-
8768,Hidden in Plain Sight,16803,16803,0,2003.csv,2003,100%,-
8769,Swim Team,16783,16783,0,2017.csv,2017,100%,-
8770,Cuban Rafters 2003 Re-release,16783,16783,0,2003.csv,2003,100%,-
8771,Night Across the Street,16778,16778,0,2013.csv,2013,100%,-
8772,Eva 2015 Re-release,16738,16738,0,2015.csv,2015,100%,-
8773,Inventing Our Life: The Kibbutz Experiment,16734,16734,0,2012.csv,2012,100%,-
8774,Medea,16714,16714,0,2003.csv,2003,100%,-
8775,This Changes Everything,16692,16692,0,2015.csv,2015,100%,-
8776,Fascination,16670,16670,0,2005.csv,2005,100%,-
8777,The World of Kanako 2015 Re-release,16627,16627,0,2015.csv,2015,100%,-
8778,The Freebie,16613,16613,0,2010.csv,2010,100%,-
8779,The Freedom to Marry,16611,16611,0,2017.csv,2017,100%,-
8780,Who Took Johnny,16595,16595,0,2015.csv,2015,100%,-
8781,Haikara-San: Here Comes Miss Modern,16572,16572,0,2018.csv,2018,100%,-
8782,Life in a Walk,16557,16557,0,2015.csv,2015,100%,-
8783,Brave New Jersey,16544,16544,0,2017.csv,2017,100%,-
8784,33 & Beyond: The Royal Art of Freemasonry,16533,16533,0,2017.csv,2017,100%,-
8785,Bright Future,16483,5166,11317,2004.csv,2004,31.3%,68.7%
8786,The Last Mogul,16469,16469,0,2005.csv,2005,100%,-
8787,Ethan Mao,16444,10178,6266,2005.csv,2005,61.9%,38.1%
8788,Mission Control: The Unsung Heroes of Apollo,16405,16405,0,2017.csv,2017,100%,-
8789,Magician: The Astonishing Life and Work of Orson Welles,16400,16400,0,2014.csv,2014,100%,-
8790,Dying to Know: Ram Dass & Timothy Leary,16397,16397,0,2017.csv,2017,100%,-
8791,Design Is One: The Vignellis,16386,16386,0,2013.csv,2013,100%,-
8792,The Intended,16290,8106,8184,2003.csv,2003,49.8%,50.2%
8793,Faster,16265,16265,0,2004.csv,2004,100%,-
8794,Onmyoji: The Yin Yang Master,16234,16234,0,2003.csv,2003,100%,-
8795,I Melt with You,16232,6361,9871,2011.csv,2011,39.2%,60.8%
8796,Perfect Opposites,16201,16201,0,2004.csv,2004,100%,-
8797,The Human Centipede III (Final Sequence),16184,16184,0,2015.csv,2015,100%,-
8798,This is Our Land,16182,11567,4615,2017.csv,2017,71.5%,28.5%
8799,All the Queen's Horses,16172,16172,0,2017.csv,2017,100%,-
8800,Detour,16172,16172,0,2018.csv,2018,100%,-
8801,Virginia Minnesota,16118,16118,0,2019.csv,2019,100%,-
8802,Levitated Mass,16086,16086,0,2014.csv,2014,100%,-
8803,1920 London,16077,0,16077,2016.csv,2016,-,100%
8804,Out of the Clear Blue Sky,16050,16050,0,2013.csv,2013,100%,-
8805,Night of Henna,16027,16027,0,2005.csv,2005,100%,-
8806,Long Shot: The Kevin Laue Story,16011,16011,0,2012.csv,2012,100%,-
8807,Planet of Snail,16002,13957,2045,2012.csv,2012,87.2%,12.8%
8808,Supercapitalist,16000,16000,0,2012.csv,2012,100%,-
8809,Wattstax,16000,16000,0,2003.csv,2003,100%,-
8810,Vulgar,15927,15927,0,2002.csv,2002,100%,-
8811,Charged: The Eduardo Garcia Story,15920,15920,0,2017.csv,2017,100%,-
8812,Can You Dig This,15909,15909,0,2015.csv,2015,100%,-
8813,Bobby G. Can't Swim,15900,15900,0,2002.csv,2002,100%,-
8814,This Binary Universe,15875,15875,0,2012.csv,2012,100%,-
8815,Starfish,15849,15849,0,2019.csv,2019,100%,-
8816,A Reason,15792,15792,0,2015.csv,2015,100%,-
8817,Defining Hope,15788,15788,0,2017.csv,2017,100%,-
8818,Take Me Home,15760,15760,0,2012.csv,2012,100%,-
8819,Full Moon in Paris,15726,15726,0,2015.csv,2015,100%,-
8820,Trinity Seven The Movie 2: Heavens Library & Crimson Lord,15712,15712,0,2019.csv,2019,100%,-
8821,People Say I'm Crazy,15679,15679,0,2004.csv,2004,100%,-
8822,A Letter to True,15635,15635,0,2004.csv,2004,100%,-
8823,7th Street,15629,15629,0,2003.csv,2003,100%,-
8824,Breakdance Academy,15628,15628,0,2010.csv,2010,100%,-
8825,Dreams Rewired,15626,11843,3783,2015.csv,2015,75.8%,24.2%
8826,Out on Stage,15623,15623,0,2018.csv,2018,100%,-
8827,The Competition 2019 Re-release,15622,15622,0,2019.csv,2019,100%,-
8828,Basmati Blues,15605,0,15605,2017.csv,2017,-,100%
8829,Five Nights in Maine,15587,15587,0,2016.csv,2016,100%,-
8830,Bob le Flambeur,15586,15586,0,2018.csv,2018,100%,-
8831,When You Read This Letter,15552,15552,0,2018.csv,2018,100%,-
8832,Postcards from London,15548,5312,10236,2018.csv,2018,34.2%,65.8%
8833,Stuffed,15532,15532,0,2019.csv,2019,100%,-
8834,Bomb the System,15520,15520,0,2005.csv,2005,100%,-
8835,Save the Green Planet!,15516,15516,0,2005.csv,2005,100%,-
8836,Last Dance,15515,15515,0,2002.csv,2002,100%,-
8837,Dreamkiller,15514,15514,0,2010.csv,2010,100%,-
8838,One Bright Shining Moment,15504,15504,0,2005.csv,2005,100%,-
8839,Tom of Finland 2018 Re-release,15483,3314,12169,2018.csv,2018,21.4%,78.6%
8840,Abouna,15476,3290,12186,2003.csv,2003,21.3%,78.7%
8841,They Will Have to Kill Us First: Malian Music In Exile,15453,7516,7937,2015.csv,2015,48.6%,51.4%
8842,California Solo,15433,15433,0,2012.csv,2012,100%,-
8843,Pipe Dream,15430,15430,0,2002.csv,2002,100%,-
8844,Formula 17 2005 Re-release,15427,15427,0,2005.csv,2005,100%,-
8845,Be Somebody,15395,15395,0,2016.csv,2016,100%,-
8846,Keeper of the Flame,15392,0,15392,2002.csv,2002,-,100%
8847,Between the Lines,15383,15383,0,2019.csv,2019,100%,-
8848,Dumbstruck,15379,15379,0,2011.csv,2011,100%,-
8849,The Adderall Diaries,15364,13191,2173,2016.csv,2016,85.9%,14.1%
8850,Wild Side,15355,15355,0,2005.csv,2005,100%,-
8851,The President,15338,7578,7760,2016.csv,2016,49.4%,50.6%
8852,Narcissister Organ Player,15334,15334,0,2018.csv,2018,100%,-
8853,Only the Young,15312,15312,0,2012.csv,2012,100%,-
8854,Contemporary Color,15305,15305,0,2017.csv,2017,100%,-
8855,Starcrossed,15263,15263,0,2016.csv,2016,100%,-
8856,Harry + Max,15247,15247,0,2005.csv,2005,100%,-
8857,Arabian Nights: Volume 2 - The Desolate One,15245,6398,8847,2015.csv,2015,42%,58%
8858,People's Republic of Desire,15241,15241,0,2018.csv,2018,100%,-
8859,The Samaritan,15220,2521,12699,2012.csv,2012,16.6%,83.4%
8860,Off the Lip,15217,15217,0,2004.csv,2004,100%,-
8861,Funan,15152,15152,0,2019.csv,2019,100%,-
8862,The Olivia Experiment,15122,15122,0,2014.csv,2014,100%,-
8863,Kung Fu Joe,15120,15120,0,2012.csv,2012,100%,-
8864,Nora,15120,15120,0,2001.csv,2001,100%,-
8865,Trade of Innocents,15091,15091,0,2012.csv,2012,100%,-
8866,Rebels on Pointe,15088,15088,0,2017.csv,2017,100%,-
8867,Khachaturian,15084,15084,0,2003.csv,2003,100%,-
8868,Cheatin',15077,15077,0,2015.csv,2015,100%,-
8869,Barefoot,15071,15071,0,2014.csv,2014,100%,-
8870,Caught in the Web,15033,1067,13966,2012.csv,2012,7.1%,92.9%
8871,I'm Not Jesus Mommy,15005,15005,0,2011.csv,2011,100%,-
8872,The Tenant,15003,15003,0,2011.csv,2011,100%,-
8873,Wrinkles the Clown,14938,14938,0,2019.csv,2019,100%,-
8874,I Declare War,14928,14928,0,2013.csv,2013,100%,-
8875,La Maison de la radio,14905,8095,6810,2013.csv,2013,54.3%,45.7%
8876,Trust Machine: The Story of Blockchain,14905,14905,0,2018.csv,2018,100%,-
8877,ZZ Top: That Little Ol' Band from Texas,14879,14879,0,2019.csv,2019,100%,-
8878,A Tale of Two Pizzas,14831,14831,0,2005.csv,2005,100%,-
8879,Reeseville,14824,14824,0,2004.csv,2004,100%,-
8880,Horses of God 2014 Re-release,14817,14817,0,2014.csv,2014,100%,-
8881,Vince Giordano: There's a Future in the Past,14807,14807,0,2017.csv,2017,100%,-
8882,Kiss of the Damned,14752,14752,0,2013.csv,2013,100%,-
8883,The Prey 2012 Re-release,14738,13959,779,2012.csv,2012,94.7%,5.3%
8884,Two Ninas,14725,14725,0,2001.csv,2001,100%,-
8885,Sweet Virginia,14725,11753,2972,2017.csv,2017,79.8%,20.2%
8886,Gloria,14701,14701,0,2015.csv,2015,100%,-
8887,30 Beats,14693,14693,0,2012.csv,2012,100%,-
8888,Circus,14693,14693,0,2000.csv,2000,100%,-
8889,Last Men in Aleppo,14637,14637,0,2017.csv,2017,100%,-
8890,10 Days in a Madhouse,14616,14616,0,2015.csv,2015,100%,-
8891,Unraveled,14615,14615,0,2012.csv,2012,100%,-
8892,The Next Big Thing,14600,14600,0,2002.csv,2002,100%,-
8893,Buzzard,14591,14591,0,2015.csv,2015,100%,-
8894,Tristana,14586,14586,0,2012.csv,2012,100%,-
8895,The Settlers,14556,14556,0,2002.csv,2002,100%,-
8896,Ferrante Fever,14518,11137,3381,2018.csv,2018,76.7%,23.3%
8897,The Wanderers 2016 Re-release,14492,14492,0,2016.csv,2016,100%,-
8898,Antarctica: Ice and Sky 2017 Re-release,14475,14475,0,2017.csv,2017,100%,-
8899,The Public Image is Rotten,14464,11293,3171,2018.csv,2018,78.1%,21.9%
8900,The 24th Day,14460,14460,0,2004.csv,2004,100%,-
8901,The Two Escobars,14457,14457,0,2010.csv,2010,100%,-
8902,My Son 2019 Re-release,14450,14450,0,2019.csv,2019,100%,-
8903,The Last Movie Star,14410,14410,0,2018.csv,2018,100%,-
8904,The Unbelievers,14400,14400,0,2013.csv,2013,100%,-
8905,The Uncondemned,14393,14393,0,2016.csv,2016,100%,-
8906,A Silent Love,14389,14389,0,2004.csv,2004,100%,-
8907,Exhibition,14378,14344,34,2014.csv,2014,99.8%,0.2%
8908,The Anarchist Cookbook,14369,14369,0,2003.csv,2003,100%,-
8909,Justice Is Mind,14360,14360,0,2013.csv,2013,100%,-
8910,Gone Doggy Gone,14354,14354,0,2015.csv,2015,100%,-
8911,Peep World,14351,14351,0,2011.csv,2011,100%,-
8912,Machines,14331,9710,4621,2017.csv,2017,67.8%,32.2%
8913,Never Stand Still,14272,14272,0,2012.csv,2012,100%,-
8914,Combat Obscura,14242,14242,0,2019.csv,2019,100%,-
8915,Saheb Biwi Aur Gangster,14231,14231,0,2011.csv,2011,100%,-
8916,Brother Nature,14218,14218,0,2016.csv,2016,100%,-
8917,Crutch,14189,14189,0,2004.csv,2004,100%,-
8918,A Perfect Man,14147,7117,7030,2013.csv,2013,50.3%,49.7%
8919,Newtown,14109,14109,0,2016.csv,2016,100%,-
8920,We Won't Grow Old Together,14104,14104,0,2012.csv,2012,100%,-
8921,Shangri-La Suite,14073,14073,0,2016.csv,2016,100%,-
8922,Gayby,14062,14062,0,2012.csv,2012,100%,-
8923,6 Month Rule,14057,14057,0,2012.csv,2012,100%,-
8924,Head Games,14056,14056,0,2012.csv,2012,100%,-
8925,Ghetto Physics,14034,14034,0,2010.csv,2010,100%,-
8926,Chasing the Blues,14030,14030,0,2018.csv,2018,100%,-
8927,Il Futuro,14001,14001,0,2013.csv,2013,100%,-
8928,Screwball,13967,13967,0,2019.csv,2019,100%,-
8929,Up for Grabs,13931,13931,0,2005.csv,2005,100%,-
8930,Yosemite,13931,13931,0,2016.csv,2016,100%,-
8931,Weed the People,13926,13926,0,2018.csv,2018,100%,-
8932,This Is Martin Bonner,13888,13888,0,2013.csv,2013,100%,-
8933,Falling Away,13869,13869,0,2012.csv,2012,100%,-
8934,Genesis,13856,6784,7072,2019.csv,2019,49%,51%
8935,Blackfoot Trail,13848,13848,0,2015.csv,2015,100%,-
8936,Sympathy for Delicious,13826,13826,0,2011.csv,2011,100%,-
8937,Stavisky...,13793,13793,0,2018.csv,2018,100%,-
8938,The Pretty One,13769,13769,0,2014.csv,2014,100%,-
8939,A Space Program,13739,13739,0,2016.csv,2016,100%,-
8940,Dorfman in Love,13737,13737,0,2013.csv,2013,100%,-
8941,Don McKay,13722,13722,0,2010.csv,2010,100%,-
8942,Time to Die,13707,13707,0,2017.csv,2017,100%,-
8943,Daisies,13692,13692,0,2012.csv,2012,100%,-
8944,This One's for the Ladies,13688,13688,0,2019.csv,2019,100%,-
8945,The Law in These Parts,13683,13683,0,2012.csv,2012,100%,-
8946,Tikkun,13671,13671,0,2016.csv,2016,100%,-
8947,Red Trees,13666,13666,0,2017.csv,2017,100%,-
8948,Soft Fruit,13654,13654,0,2000.csv,2000,100%,-
8949,Fifi Howls from Happiness,13614,13614,0,2014.csv,2014,100%,-
8950,When the Iron Bird Flies: Tibetan Buddhism Arrives in the West,13598,13598,0,2012.csv,2012,100%,-
8951,Stray Dogs,13573,10433,3140,2014.csv,2014,76.9%,23.1%
8952,Eli,13547,13547,0,2015.csv,2015,100%,-
8953,Dysfunctional Friends,13546,13546,0,2012.csv,2012,100%,-
8954,Paper Man,13514,13514,0,2010.csv,2010,100%,-
8955,Duane Hopwood,13510,13510,0,2005.csv,2005,100%,-
8956,Handsome Harry,13500,13500,0,2010.csv,2010,100%,-
8957,Shadowman,13498,13498,0,2017.csv,2017,100%,-
8958,Looking for an Echo,13465,13465,0,2000.csv,2000,100%,-
8959,Spices of Liberty,13463,13463,0,2016.csv,2016,100%,-
8960,The Slaughter Rule,13411,13411,0,2003.csv,2003,100%,-
8961,War of the Worlds: Goliath,13385,13385,0,2014.csv,2014,100%,-
8962,Solaris 2017 Re-release,13352,0,13352,2017.csv,2017,-,100%
8963,Yes Nurse! No Nurse! 2004 Re-release,13325,13325,0,2004.csv,2004,100%,-
8964,Violet Tendencies,13304,13304,0,2010.csv,2010,100%,-
8965,Rapid Response,13294,13294,0,2019.csv,2019,100%,-
8966,The Specials,13276,13276,0,2000.csv,2000,100%,-
8967,Late Spring,13254,13254,0,2016.csv,2016,100%,-
8968,Days and Nights,13243,13243,0,2014.csv,2014,100%,-
8969,Our Blood is Wine,13210,13210,0,2018.csv,2018,100%,-
8970,"Intent to Destroy: Death, Denial & Depiction",13194,13194,0,2017.csv,2017,100%,-
8971,Sol LeWitt,13146,13146,0,2014.csv,2014,100%,-
8972,The Pleasures of Being Out of Step,13137,13137,0,2014.csv,2014,100%,-
8973,The Trouble with Bliss,13093,13093,0,2012.csv,2012,100%,-
8974,Under the Boardwalk: The Monopoly Story,13080,13080,0,2011.csv,2011,100%,-
8975,Nothing But a Man,13063,13063,0,2012.csv,2012,100%,-
8976,"How Much Does Your Building Weigh, Mr Foster? 2012 Re-release",13013,13013,0,2012.csv,2012,100%,-
8977,Jim,13000,13000,0,2010.csv,2010,100%,-
8978,Bloodworth,12971,12971,0,2011.csv,2011,100%,-
8979,Like Me,12965,12965,0,2018.csv,2018,100%,-
8980,K2: Siren of the Himalayas,12959,12959,0,2014.csv,2014,100%,-
8981,The Last Rampage,12944,6294,6650,2017.csv,2017,48.6%,51.4%
8982,A Green Story,12901,12901,0,2013.csv,2013,100%,-
8983,Taipei Story,12897,12897,0,2017.csv,2017,100%,-
8984,Permanent,12847,12847,0,2017.csv,2017,100%,-
8985,The Taqwacores,12839,11445,1394,2010.csv,2010,89.1%,10.9%
8986,Children Underground,12798,12798,0,2001.csv,2001,100%,-
8987,Junction 48,12795,12795,0,2017.csv,2017,100%,-
8988,Yakuza Apocalypse,12756,12756,0,2015.csv,2015,100%,-
8989,Virginia,12728,12728,0,2012.csv,2012,100%,-
8990,Breakdance Academy 2013 Re-release,12708,12708,0,2013.csv,2013,100%,-
8991,Concerning Violence,12680,12680,0,2014.csv,2014,100%,-
8992,Heal,12668,12668,0,2017.csv,2017,100%,-
8993,Bhopal: A Prayer for Rain,12628,12628,0,2014.csv,2014,100%,-
8994,Kangaroo,12626,4547,8079,2018.csv,2018,36%,64%
8995,Lansdown,12614,12614,0,2002.csv,2002,100%,-
8996,American Socialist: The Life and Times of Eugene Victor Debs,12609,12609,0,2018.csv,2018,100%,-
8997,Gory Gory Hallelujah,12604,12604,0,2005.csv,2005,100%,-
8998,Freestyle: The Art of Rhyme,12600,12600,0,2004.csv,2004,100%,-
8999,Buddy Boy,12597,12597,0,2000.csv,2000,100%,-
9000,Boy Meets Girl,12589,12589,0,2014.csv,2014,100%,-
9001,Husbands in Goa,12588,10135,2453,2012.csv,2012,80.5%,19.5%
9002,Of Fathers and Sons,12579,12579,0,2018.csv,2018,100%,-
9003,Around June,12578,12578,0,2012.csv,2012,100%,-
9004,My Art,12554,12554,0,2018.csv,2018,100%,-
9005,Daltry Calhoun,12551,12551,0,2005.csv,2005,100%,-
9006,Off Season,12544,12544,0,2019.csv,2019,100%,-
9007,The Far Side of the Moon 2005 Re-release,12534,12534,0,2005.csv,2005,100%,-
9008,City of Women,12516,12516,0,2016.csv,2016,100%,-
9009,Seven Beauties,12408,12408,0,2017.csv,2017,100%,-
9010,American Chaos,12368,12368,0,2018.csv,2018,100%,-
9011,America the Beautiful 2: The Thin Commandments,12366,12366,0,2011.csv,2011,100%,-
9012,Rebirth,12358,12358,0,2011.csv,2011,100%,-
9013,Spin,12355,12355,0,2004.csv,2004,100%,-
9014,L'héritage de la chouette,12316,12316,0,2018.csv,2018,100%,-
9015,The Dust Factory,12311,12311,0,2004.csv,2004,100%,-
9016,Big Ain't Bad,12288,12288,0,2004.csv,2004,100%,-
9017,4 Days in France,12273,12273,0,2017.csv,2017,100%,-
9018,The Armor of Light,12267,12267,0,2015.csv,2015,100%,-
9019,Wa-shoku Dream: Beyond Sushi,12240,12240,0,2015.csv,2015,100%,-
9020,The Living Wake,12232,12232,0,2010.csv,2010,100%,-
9021,Bricked,12201,12201,0,2019.csv,2019,100%,-
9022,Elstree 1976,12173,12173,0,2016.csv,2016,100%,-
9023,Destiny,12156,12156,0,2016.csv,2016,100%,-
9024,Touch the Wall,12156,12156,0,2014.csv,2014,100%,-
9025,Greetings from Tim Buckley,12155,11157,998,2013.csv,2013,91.8%,8.2%
9026,Shahid,12153,12153,0,2013.csv,2013,100%,-
9027,Back Door Channels: The Price of Peace,12139,12139,0,2011.csv,2011,100%,-
9028,In No Great Hurry: 13 Lessons in Life with Saul Leiter,12133,12133,0,2014.csv,2014,100%,-
9029,The Most Unknown,12119,12119,0,2018.csv,2018,100%,-
9030,Call Me Kuchu,12110,9124,2986,2012.csv,2012,75.3%,24.7%
9031,Zen for Nothing,12107,12107,0,2019.csv,2019,100%,-
9032,Hot Water,12101,12101,0,2016.csv,2016,100%,-
9033,The Kids Grow Up,12095,12095,0,2010.csv,2010,100%,-
9034,A Murder in the Park,12088,12088,0,2015.csv,2015,100%,-
9035,When Two Worlds Collide,12080,12080,0,2016.csv,2016,100%,-
9036,Little England 2015 Re-release,12077,12077,0,2015.csv,2015,100%,-
9037,Close Call,12077,12077,0,2004.csv,2004,100%,-
9038,Imprisoned,12050,12050,0,2019.csv,2019,100%,-
9039,Quartet,12042,12042,0,2019.csv,2019,100%,-
9040,Lost Angels: Skid Row Is My Home,12025,12025,0,2012.csv,2012,100%,-
9041,Queen Margot 2014 Re-release,12005,12005,0,2014.csv,2014,100%,-
9042,Shaye & Kiki,12000,12000,0,2002.csv,2002,100%,-
9043,Rick,11991,11991,0,2004.csv,2004,100%,-
9044,The Legend of Leigh Bowery,11989,11989,0,2003.csv,2003,100%,-
9045,All Babes Want to Kill Me,11975,11975,0,2005.csv,2005,100%,-
9046,Autumn Sonata 2017 Re-release,11959,0,11959,2017.csv,2017,-,100%
9047,The Strange Little Cat,11956,5885,6071,2014.csv,2014,49.2%,50.8%
9048,The Last Race,11947,11947,0,2018.csv,2018,100%,-
9049,Frank Serpico,11925,11925,0,2017.csv,2017,100%,-
9050,Yellow Asphalt,11907,11907,0,2002.csv,2002,100%,-
9051,"Cassandro, The Exotico!",11897,11897,0,2019.csv,2019,100%,-
9052,New York in the 50's,11882,11882,0,2001.csv,2001,100%,-
9053,Smokers Only,11871,11871,0,2002.csv,2002,100%,-
9054,Revenge of the Mekons,11861,11861,0,2014.csv,2014,100%,-
9055,Les Parents Terribles,11818,11818,0,2018.csv,2018,100%,-
9056,Janice Beard,11816,11816,0,2002.csv,2002,100%,-
9057,Emptying the Skies,11811,11811,0,2015.csv,2015,100%,-
9058,The Dry Land,11777,11777,0,2010.csv,2010,100%,-
9059,Summer '03,11746,11746,0,2018.csv,2018,100%,-
9060,Rid of Me,11740,11740,0,2011.csv,2011,100%,-
9061,Writer of O,11728,11728,0,2005.csv,2005,100%,-
9062,Lucha Mexico,11722,11722,0,2016.csv,2016,100%,-
9063,White Wedding 2010 Re-release,11710,11710,0,2010.csv,2010,100%,-
9064,My Voyage to Italy,11683,11683,0,2001.csv,2001,100%,-
9065,36 Saints,11640,11640,0,2013.csv,2013,100%,-
9066,The Tribes of Palos Verdes,11603,11603,0,2017.csv,2017,100%,-
9067,11 Flowers,11599,9213,2386,2012.csv,2012,79.4%,20.6%
9068,Around India with a Movie Camera,11568,10389,1179,2018.csv,2018,89.8%,10.2%
9069,Crop Circles: Quest for Truth,11562,11562,0,2002.csv,2002,100%,-
9070,Intoxicating,11560,11560,0,2004.csv,2004,100%,-
9071,The Preppie Connection,11558,11558,0,2016.csv,2016,100%,-
9072,River of Grass,11553,11553,0,2016.csv,2016,100%,-
9073,The Ruins of Lifta,11548,11548,0,2016.csv,2016,100%,-
9074,Ultrasuede: In Search of Halston,11539,11539,0,2012.csv,2012,100%,-
9075,After the Cup: Sons of Sakhnin United,11538,11538,0,2010.csv,2010,100%,-
9076,Girl Play,11523,11523,0,2005.csv,2005,100%,-
9077,Elektra Luxx,11514,11514,0,2011.csv,2011,100%,-
9078,Manfast,11480,11480,0,2003.csv,2003,100%,-
9079,The Final Member,11428,11428,0,2014.csv,2014,100%,-
9080,The Great Invisible,11428,11428,0,2014.csv,2014,100%,-
9081,The Mesmerist,11422,11422,0,2002.csv,2002,100%,-
9082,Love Forbidden 2003 Re-release,11421,11421,0,2003.csv,2003,100%,-
9083,Beside Bowie: The Mick Ronson Story,11400,11400,0,2017.csv,2017,100%,-
9084,Camera Obscura,11384,11384,0,2003.csv,2003,100%,-
9085,Family Fundamentals,11344,11344,0,2002.csv,2002,100%,-
9086,Rendezvous in July,11321,11321,0,2018.csv,2018,100%,-
9087,Saigon Bodyguards,11314,11314,0,2017.csv,2017,100%,-
9088,Viktoria,11314,11314,0,2016.csv,2016,100%,-
9089,Cinemania,11305,11305,0,2003.csv,2003,100%,-
9090,Dishkiyaoon,11288,11288,0,2014.csv,2014,100%,-
9091,Theo Who Lived,11271,11271,0,2016.csv,2016,100%,-
9092,Daylight's End,11257,0,11257,2016.csv,2016,-,100%
9093,Bullitt County,11257,11257,0,2018.csv,2018,100%,-
9094,In Like Flynn,11255,11255,0,2019.csv,2019,100%,-
9095,Hacker,11239,11239,0,2016.csv,2016,100%,-
9096,The Pathological Optimist,11222,11222,0,2017.csv,2017,100%,-
9097,Children of Invention,11183,11183,0,2010.csv,2010,100%,-
9098,Made Me Do It,11151,11151,0,2019.csv,2019,100%,-
9099,"Now, Forager",11146,11146,0,2012.csv,2012,100%,-
9100,InSight,11100,11100,0,2011.csv,2011,100%,-
9101,Winning Girls Through Psychic Mind Control,11089,11089,0,2005.csv,2005,100%,-
9102,Edward II 2018 Re-release,11055,4826,6229,2018.csv,2018,43.7%,56.3%
9103,The Challenge,11043,11043,0,2017.csv,2017,100%,-
9104,The Woman with the 5 Elephants 2011 Re-release,11026,11026,0,2011.csv,2011,100%,-
9105,Gasoline,11023,11023,0,2003.csv,2003,100%,-
9106,PAY 2 PLAY: Democracy's High Stakes,11021,11021,0,2014.csv,2014,100%,-
9107,Midget Zombie Takeover,11006,11006,0,2013.csv,2013,100%,-
9108,Manito,11000,11000,0,2003.csv,2003,100%,-
9109,Christina,11000,11000,0,2010.csv,2010,100%,-
9110,Pauly Shore Is Dead,11000,11000,0,2004.csv,2004,100%,-
9111,Suburban Birds,10997,10997,0,2019.csv,2019,100%,-
9112,Just Before I Go,10970,10970,0,2015.csv,2015,100%,-
9113,Digging Up the Marrow,10969,10969,0,2015.csv,2015,100%,-
9114,Very Good Girls,10963,6940,4023,2014.csv,2014,63.3%,36.7%
9115,Wallander: Hämnden 2012 Re-release,10960,10960,0,2012.csv,2012,100%,-
9116,Sarah Palin: You Betcha!,10935,10935,0,2011.csv,2011,100%,-
9117,If the Dancer Dances,10912,10912,0,2019.csv,2019,100%,-
9118,MC5*: A True Testimonial,10888,10888,0,2004.csv,2004,100%,-
9119,Stardom,10886,10886,0,2000.csv,2000,100%,-
9120,As It Is in Heaven,10850,10850,0,2014.csv,2014,100%,-
9121,What Happened Last Night,10844,10844,0,2016.csv,2016,100%,-
9122,The Forecaster,10824,10172,652,2015.csv,2015,94%,6%
9123,Bleeding Heart,10815,0,10815,2015.csv,2015,-,100%
9124,Terkel in Trouble 2010 Re-release,10783,10783,0,2010.csv,2010,100%,-
9125,The Man Who Shook the Hand of Vicente Fernandez,10782,10782,0,2012.csv,2012,100%,-
9126,Vision Portraits,10771,10771,0,2019.csv,2019,100%,-
9127,Mala Mala,10761,10761,0,2015.csv,2015,100%,-
9128,A Resurrection,10730,10730,0,2013.csv,2013,100%,-
9129,Hollow in the Land,10688,0,10688,2017.csv,2017,-,100%
9130,Made in Cleveland,10681,10681,0,2013.csv,2013,100%,-
9131,Frankie & Alice,10670,10670,0,2010.csv,2010,100%,-
9132,National Bird,10656,10656,0,2016.csv,2016,100%,-
9133,American Meat,10650,10650,0,2013.csv,2013,100%,-
9134,Caucus,10645,10645,0,2013.csv,2013,100%,-
9135,Mind the Gap,10637,10637,0,2004.csv,2004,100%,-
9136,One More Round,10629,10629,0,2005.csv,2005,100%,-
9137,Lovesong,10626,10626,0,2017.csv,2017,100%,-
9138,Inside the Mind of Leonardo,10600,10600,0,2014.csv,2014,100%,-
9139,Marriage Italian Style 2011 Re-release,10600,10600,0,2011.csv,2011,100%,-
9140,Nola,10550,10550,0,2003.csv,2003,100%,-
9141,China Heavyweight,10550,10550,0,2012.csv,2012,100%,-
9142,Fighting Tommy Riley,10514,10514,0,2005.csv,2005,100%,-
9143,Waiting for Armageddon,10501,10501,0,2010.csv,2010,100%,-
9144,Clarence,10495,10495,0,2017.csv,2017,100%,-
9145,Santa Mesa,10490,10490,0,2012.csv,2012,100%,-
9146,Neon Flesh 2012 Re-release,10483,0,10483,2012.csv,2012,-,100%
9147,"Norte, the End of History",10457,10457,0,2014.csv,2014,100%,-
9148,Evil Intent,10454,10454,0,2013.csv,2013,100%,-
9149,Class Rank,10452,10452,0,2018.csv,2018,100%,-
9150,Let's Get Frank,10440,10440,0,2004.csv,2004,100%,-
9151,Mama Africa 2018 Re-release,10430,10430,0,2018.csv,2018,100%,-
9152,Love in the Time of Money,10410,10410,0,2002.csv,2002,100%,-
9153,The Advocates,10402,10402,0,2018.csv,2018,100%,-
9154,Shanghai Calling,10400,10400,0,2013.csv,2013,100%,-
9155,Elemental,10358,10358,0,2013.csv,2013,100%,-
9156,Zero Bridge,10357,10357,0,2011.csv,2011,100%,-
9157,SK1 2016 Re-release,10330,10330,0,2016.csv,2016,100%,-
9158,Oasis 2004 Re-release,10304,10304,0,2004.csv,2004,100%,-
9159,Painted Woman,10298,10298,0,2017.csv,2017,100%,-
9160,Shepard & Dark,10278,10278,0,2013.csv,2013,100%,-
9161,Moebius,10254,2340,7914,2014.csv,2014,22.8%,77.2%
9162,The Endless Summer,10233,10233,0,2014.csv,2014,100%,-
9163,Amelia 2.0,10233,10233,0,2017.csv,2017,100%,-
9164,Approaching the Unknown,10232,10232,0,2016.csv,2016,100%,-
9165,Tip Top,10201,6050,4151,2013.csv,2013,59.3%,40.7%
9166,When Lambs Become Lions,10197,9337,860,2019.csv,2019,91.6%,8.4%
9167,Prince of the Himalayas,10190,10190,0,2011.csv,2011,100%,-
9168,Miss Minoes 2011 Re-release,10189,10189,0,2011.csv,2011,100%,-
9169,A Bird of the Air,10152,10152,0,2011.csv,2011,100%,-
9170,Revolution #9,10133,10133,0,2002.csv,2002,100%,-
9171,Beta Test,10104,10104,0,2016.csv,2016,100%,-
9172,Putin's Kiss,10082,10082,0,2012.csv,2012,100%,-
9173,Pawn Shop Chronicles,10080,8088,1992,2013.csv,2013,80.2%,19.8%
9174,Before I Disappear,10078,10078,0,2014.csv,2014,100%,-
9175,Little Accidents,10071,10071,0,2015.csv,2015,100%,-
9176,Informant,10068,10068,0,2013.csv,2013,100%,-
9177,The Sunshine Makers,10042,10042,0,2017.csv,2017,100%,-
9178,Circle,10024,10024,0,2010.csv,2010,100%,-
9179,The Life and Mind of Mark DeFriest,10021,10021,0,2015.csv,2015,100%,-
9180,Arjun: The Warrior Prince,10017,10017,0,2012.csv,2012,100%,-
9181,The Do-Deca-Pentathlon,10000,10000,0,2012.csv,2012,100%,-
9182,"Hugh Hefner: Playboy, Activist and Rebel",10000,10000,0,2010.csv,2010,100%,-
9183,Tere Bin Laden: Dead Or Alive,9995,0,9995,2016.csv,2016,-,100%
9184,Made in France,9956,9956,0,2016.csv,2016,100%,-
9185,Olivia,9934,9934,0,2019.csv,2019,100%,-
9186,Streetwise,9904,9904,0,2019.csv,2019,100%,-
9187,Take Care of My Cat,9866,9866,0,2002.csv,2002,100%,-
9188,52 Tuesdays,9844,0,9844,2015.csv,2015,-,100%
9189,Kabbalah Me,9816,9816,0,2014.csv,2014,100%,-
9190,Down Terrace,9812,9812,0,2010.csv,2010,100%,-
9191,Birth of the Living Dead,9802,9802,0,2013.csv,2013,100%,-
9192,Cuba: Island of Music,9791,9791,0,2004.csv,2004,100%,-
9193,Pelle the Conqueror 2017 Re-release,9757,9757,0,2017.csv,2017,100%,-
9194,Finding Home,9736,9736,0,2005.csv,2005,100%,-
9195,All the Rage,9730,9730,0,2000.csv,2000,100%,-
9196,The President's Last Bang,9724,9724,0,2005.csv,2005,100%,-
9197,"If You Don't, I Will",9719,9719,0,2014.csv,2014,100%,-
9198,Antoine and Antoinette,9704,9704,0,2013.csv,2013,100%,-
9199,Brutal Beauty: Tales of the Rose City Rollers,9677,9677,0,2010.csv,2010,100%,-
9200,The Quest of Alain Ducasse,9627,9627,0,2018.csv,2018,100%,-
9201,Virgin,9614,9614,0,2004.csv,2004,100%,-
9202,The Spanish Prisoner 2019 Re-release,9589,9589,0,2019.csv,2019,100%,-
9203,Vito Bonafacci,9570,9570,0,2011.csv,2011,100%,-
9204,Chosen,9536,9283,253,2016.csv,2016,97.3%,2.7%
9205,The Lost Arcade,9522,9522,0,2016.csv,2016,100%,-
9206,Strangers on the Earth,9518,9518,0,2018.csv,2018,100%,-
9207,Living Proof,9512,9512,0,2017.csv,2017,100%,-
9208,In the House of Flies,9480,9480,0,2014.csv,2014,100%,-
9209,Claire Dolan,9480,9480,0,2000.csv,2000,100%,-
9210,Northern Lights,9453,9453,0,2013.csv,2013,100%,-
9211,If I Were You,9432,9432,0,2013.csv,2013,100%,-
9212,I'll Sing for You 2004 Re-release,9425,9425,0,2004.csv,2004,100%,-
9213,Zero Charisma,9417,9417,0,2013.csv,2013,100%,-
9214,"One Cut, One Life",9406,9406,0,2015.csv,2015,100%,-
9215,"L'Chayim, Comrade Stalin",9397,9397,0,2003.csv,2003,100%,-
9216,Innocence and Experience: The Making of 'The Age of Innocence',9395,9395,0,2005.csv,2005,100%,-
9217,First Love 2005 Re-release,9392,9392,0,2005.csv,2005,100%,-
9218,Miss Kiet's Children 2017 Re-release,9384,9384,0,2017.csv,2017,100%,-
9219,Acts of Worship,9377,9377,0,2003.csv,2003,100%,-
9220,The Tree of Wooden Clogs,9367,0,9367,2016.csv,2016,-,100%
9221,Radio Free Albemuth,9365,9365,0,2014.csv,2014,100%,-
9222,Fritz Lang's Indian Epic 2019 re-release,9345,9345,0,2019.csv,2019,100%,-
9223,The End of Love,9342,9342,0,2013.csv,2013,100%,-
9224,Looking for Maria Sanchez,9338,9338,0,2013.csv,2013,100%,-
9225,The Immortalists,9331,9331,0,2014.csv,2014,100%,-
9226,Milk and Honey,9331,9331,0,2005.csv,2005,100%,-
9227,Better Mus' Come,9318,9318,0,2013.csv,2013,100%,-
9228,Wonderful World,9309,9309,0,2010.csv,2010,100%,-
9229,The City Dark,9269,9269,0,2012.csv,2012,100%,-
9230,Hooligan Sparrow,9263,9263,0,2016.csv,2016,100%,-
9231,The Sacrament,9221,9221,0,2014.csv,2014,100%,-
9232,A Dark Place,9212,0,9212,2019.csv,2019,-,100%
9233,Cracked Up,9197,9197,0,2019.csv,2019,100%,-
9234,Ghost Team One,9195,9195,0,2013.csv,2013,100%,-
9235,Trouble Every Day 2013 Re-release,9189,9189,0,2013.csv,2013,100%,-
9236,Frank & Lola,9188,9188,0,2016.csv,2016,100%,-
9237,The Young Girl and the Monsoon,9186,9186,0,2001.csv,2001,100%,-
9238,The Hollow Point,9149,0,9149,2016.csv,2016,-,100%
9239,Thirst Street,9129,9129,0,2017.csv,2017,100%,-
9240,Cupcakes,9129,9129,0,2015.csv,2015,100%,-
9241,The Ardennes 2016 Re-release,9116,5638,3478,2016.csv,2016,61.8%,38.2%
9242,Faith Connections,9111,9111,0,2014.csv,2014,100%,-
9243,Lycan,9110,9110,0,2017.csv,2017,100%,-
9244,The Eyes,9104,9104,0,2017.csv,2017,100%,-
9245,Julian Schnabel: A Private Portrait,9103,9103,0,2017.csv,2017,100%,-
9246,Decoding Deepak,9100,9100,0,2012.csv,2012,100%,-
9247,Il Posto,9080,9080,0,2002.csv,2002,100%,-
9248,Gerontophilia 2015 Re-release,9074,4916,4158,2015.csv,2015,54.2%,45.8%
9249,El Mar La Mar,9065,9065,0,2018.csv,2018,100%,-
9250,Living Life,9064,9064,0,2005.csv,2005,100%,-
9251,Frantz Fanon: Black Skin White Mask,9025,9025,0,2019.csv,2019,100%,-
9252,Step Up: High Water,9005,9005,0,2018.csv,2018,100%,-
9253,Money Fight,9004,9004,0,2012.csv,2012,100%,-
9254,Station to Station,9000,9000,0,2015.csv,2015,100%,-
9255,Mosquita y Mari,9000,9000,0,2012.csv,2012,100%,-
9256,Zoo Wars,8998,8998,0,2018.csv,2018,100%,-
9257,Revolt,8986,0,8986,2017.csv,2017,-,100%
9258,Survivors Guide To Prison,8982,8982,0,2018.csv,2018,100%,-
9259,Colossal Youth,8968,8331,637,2018.csv,2018,92.9%,7.1%
9260,Big Words,8965,8965,0,2013.csv,2013,100%,-
9261,Three Stars,8942,8942,0,2012.csv,2012,100%,-
9262,Summer of '67,8941,8941,0,2018.csv,2018,100%,-
9263,This is Congo,8905,7051,1854,2018.csv,2018,79.2%,20.8%
9264,B-Side,8870,8870,0,2015.csv,2015,100%,-
9265,The Swenkas,8860,8860,0,2005.csv,2005,100%,-
9266,Missing Young Woman,8858,8858,0,2003.csv,2003,100%,-
9267,The Meanest Man in Texas,8850,8850,0,2019.csv,2019,100%,-
9268,The Pardon,8845,8845,0,2015.csv,2015,100%,-
9269,Providence,8840,8840,0,2016.csv,2016,100%,-
9270,Home Run Showdown,8824,8824,0,2012.csv,2012,100%,-
9271,That Part Feeling - the Universe of Arvo Part,8812,8812,0,2019.csv,2019,100%,-
9272,The Cabinet of Dr. Caligari 2014 Re-release,8811,8811,0,2014.csv,2014,100%,-
9273,Dawn of the Crescent Moon,8799,8799,0,2015.csv,2015,100%,-
9274,Hell Baby,8785,8785,0,2013.csv,2013,100%,-
9275,Bounce: Behind the Velvet Rope,8779,8779,0,2001.csv,2001,100%,-
9276,Evil Remains,8747,8747,0,2004.csv,2004,100%,-
9277,Everything Put Together,8741,2963,5778,2001.csv,2001,33.9%,66.1%
9278,Only When I Dance,8738,8738,0,2010.csv,2010,100%,-
9279,The Man in the White Suit,8718,8718,0,2012.csv,2012,100%,-
9280,Blood Feast,8708,8708,0,2018.csv,2018,100%,-
9281,Amnesia,8700,8700,0,2017.csv,2017,100%,-
9282,Man on a Mission: Richard Garriott's Road to the Stars,8688,8688,0,2012.csv,2012,100%,-
9283,"Small, Beautifully Moving Parts",8631,8631,0,2012.csv,2012,100%,-
9284,Meet Me in Montenegro,8612,8612,0,2015.csv,2015,100%,-
9285,Almost Human,8608,8447,161,2014.csv,2014,98.1%,1.9%
9286,Mojave,8602,8253,349,2016.csv,2016,95.9%,4.1%
9287,Farewell to Hollywood,8601,8601,0,2015.csv,2015,100%,-
9288,General Education,8601,8601,0,2012.csv,2012,100%,-
9289,Kaena: The Prophecy 2004 Re-release,8593,8593,0,2004.csv,2004,100%,-
9290,Lucky,8564,8564,0,2011.csv,2011,100%,-
9291,From the East,8540,8540,0,2016.csv,2016,100%,-
9292,Inspector Maigret,8528,8528,0,2017.csv,2017,100%,-
9293,The Quitter,8512,8512,0,2014.csv,2014,100%,-
9294,The Empty Hours,8478,8244,234,2014.csv,2014,97.2%,2.8%
9295,Furlough,8472,8472,0,2018.csv,2018,100%,-
9296,Zero Day,8466,8466,0,2003.csv,2003,100%,-
9297,Canopy,8462,8462,0,2014.csv,2014,100%,-
9298,The Institute,8445,8445,0,2013.csv,2013,100%,-
9299,We Are the Flesh,8438,8438,0,2017.csv,2017,100%,-
9300,Hello Herman,8437,8437,0,2013.csv,2013,100%,-
9301,Red Hollywood,8426,8426,0,2014.csv,2014,100%,-
9302,The Happy Sad,8395,8395,0,2013.csv,2013,100%,-
9303,Downloaded,8377,8377,0,2013.csv,2013,100%,-
9304,Counting,8374,8374,0,2015.csv,2015,100%,-
9305,Gilbert,8362,8362,0,2017.csv,2017,100%,-
9306,The Rising Place,8360,8360,0,2002.csv,2002,100%,-
9307,Eternity: The Movie,8350,8350,0,2014.csv,2014,100%,-
9308,Gringo Trails,8349,8349,0,2014.csv,2014,100%,-
9309,A Teacher,8348,8348,0,2013.csv,2013,100%,-
9310,Natasha,8325,8325,0,2017.csv,2017,100%,-
9311,The Dead Center,8320,8320,0,2019.csv,2019,100%,-
9312,About Cherry,8315,3003,5312,2012.csv,2012,36.1%,63.9%
9313,Mr. Chibbs,8302,8302,0,2017.csv,2017,100%,-
9314,Served Like a Girl,8290,8290,0,2017.csv,2017,100%,-
9315,We Are Twisted Fucking Sister!,8277,8277,0,2016.csv,2016,100%,-
9316,Life Partners,8265,8265,0,2014.csv,2014,100%,-
9317,Aliyah,8253,8253,0,2013.csv,2013,100%,-
9318,Silicon Cowboys,8239,8239,0,2016.csv,2016,100%,-
9319,Brooklyn Brothers Beat the Best,8210,7466,744,2012.csv,2012,90.9%,9.1%
9320,Spiral,8190,8190,0,2018.csv,2018,100%,-
9321,Jellyfish Eyes,8176,8176,0,2015.csv,2015,100%,-
9322,Anatahan,8171,8171,0,2017.csv,2017,100%,-
9323,Suspended Animation,8169,8169,0,2003.csv,2003,100%,-
9324,The Other Side,8168,8074,94,2016.csv,2016,98.8%,1.2%
9325,Far from Vietnam,8132,8132,0,2013.csv,2013,100%,-
9326,Twist of Faith,8129,8129,0,2005.csv,2005,100%,-
9327,From Nowhere,8109,8109,0,2017.csv,2017,100%,-
9328,Restless City,8100,8100,0,2012.csv,2012,100%,-
9329,Next Year Jerusalem,8093,8093,0,2014.csv,2014,100%,-
9330,In the Mirror of Maya Deren,8077,8077,0,2003.csv,2003,100%,-
9331,Golden Kingdom,8077,8077,0,2016.csv,2016,100%,-
9332,16 Years of Alcohol,8046,8046,0,2005.csv,2005,100%,-
9333,No Turning Back,8042,8042,0,2003.csv,2003,100%,-
9334,Steak (R)evolution,8038,8025,13,2015.csv,2015,99.8%,0.2%
9335,Straight Outta Tompkins,8022,8022,0,2015.csv,2015,100%,-
9336,Occupation: Dreamland,8018,8018,0,2005.csv,2005,100%,-
9337,The Scoundrel's Wife,8018,8018,0,2003.csv,2003,100%,-
9338,Talent Has Hunger,7998,7998,0,2016.csv,2016,100%,-
9339,All About Evil,7995,7995,0,2010.csv,2010,100%,-
9340,One Small Hitch 2015 Re-release,7965,7965,0,2015.csv,2015,100%,-
9341,Roseanne for President!,7960,7960,0,2016.csv,2016,100%,-
9342,Stolen,7943,7943,0,2010.csv,2010,100%,-
9343,A Decent Factory,7925,7925,0,2005.csv,2005,100%,-
9344,Mugabe and the White African,7924,7924,0,2010.csv,2010,100%,-
9345,Angels Are Made Of Light,7919,7919,0,2019.csv,2019,100%,-
9346,Portrait of a Garden,7914,7914,0,2016.csv,2016,100%,-
9347,This Magnificent Cake!,7888,7888,0,2019.csv,2019,100%,-
9348,Bleak Street,7888,0,7888,2015.csv,2015,-,100%
9349,Swept Away,7876,7876,0,2017.csv,2017,100%,-
9350,Zenith,7862,7862,0,2010.csv,2010,100%,-
9351,The Ballad of Lefty Brown,7856,7856,0,2017.csv,2017,100%,-
9352,Ghost Fleet,7850,7850,0,2019.csv,2019,100%,-
9353,Prince of Central Park,7838,7838,0,2000.csv,2000,100%,-
9354,Roadie,7825,7825,0,2012.csv,2012,100%,-
9355,Photographic Memory,7822,7822,0,2012.csv,2012,100%,-
9356,The Great Man,7814,7814,0,2015.csv,2015,100%,-
9357,Archipelago 2014 Re-release,7791,7791,0,2014.csv,2014,100%,-
9358,Old Stone,7768,7476,292,2016.csv,2016,96.2%,3.8%
9359,The Plagiarists,7768,7768,0,2019.csv,2019,100%,-
9360,And While We Were Here,7750,7750,0,2013.csv,2013,100%,-
9361,Come Back to Me,7744,7744,0,2014.csv,2014,100%,-
9362,Young Ones,7740,0,7740,2014.csv,2014,-,100%
9363,Gregory's Girl,7710,7710,0,2019.csv,2019,100%,-
9364,Maurizio Cattelan: Be Right Back,7706,7706,0,2017.csv,2017,100%,-
9365,I Don't Belong Anywhere: The Cinema of Chantal Akerman,7703,7703,0,2016.csv,2016,100%,-
9366,Witness for the Prosecution,7693,0,7693,2003.csv,2003,-,100%
9367,I'll Take Your Dead,7692,7692,0,2019.csv,2019,100%,-
9368,With All Deliberate Speed,7690,7690,0,2004.csv,2004,100%,-
9369,Running Shaadi,7674,0,7674,2017.csv,2017,-,100%
9370,Last Days Here,7643,7643,0,2012.csv,2012,100%,-
9371,Legend of the Mountain,7640,7640,0,2018.csv,2018,100%,-
9372,Wasabi Tuna,7631,7631,0,2004.csv,2004,100%,-
9373,Raman Raghav 2.0,7612,0,7612,2016.csv,2016,-,100%
9374,Area 51,7556,7556,0,2015.csv,2015,100%,-
9375,The Wrong Light,7553,7553,0,2017.csv,2017,100%,-
9376,Controlled Chaos,7549,7549,0,2003.csv,2003,100%,-
9377,Tales from the Script,7535,7535,0,2010.csv,2010,100%,-
9378,Girls Against Boys,7529,7529,0,2013.csv,2013,100%,-
9379,Birthright: A War Story,7519,7519,0,2017.csv,2017,100%,-
9380,Udaan,7461,7461,0,2010.csv,2010,100%,-
9381,The Little Bedroom 2014 Re-release,7440,7440,0,2014.csv,2014,100%,-
9382,Raze,7429,7429,0,2014.csv,2014,100%,-
9383,Bel Borba Aqui,7426,7426,0,2012.csv,2012,100%,-
9384,The Dogwalker,7420,7420,0,2002.csv,2002,100%,-
9385,Rubble Kings,7416,7416,0,2015.csv,2015,100%,-
9386,Price Check,7413,7413,0,2012.csv,2012,100%,-
9387,The Giant Mechanical Man,7396,7396,0,2012.csv,2012,100%,-
9388,Silent Waters,7384,7384,0,2004.csv,2004,100%,-
9389,Desperate Acts of Magic,7373,7373,0,2013.csv,2013,100%,-
9390,Gendernauts: A Journey Through Shifting Identities,7358,7358,0,2000.csv,2000,100%,-
9391,Big Time,7347,7347,0,2017.csv,2017,100%,-
9392,Shoah: Four Sisters,7323,7323,0,2018.csv,2018,100%,-
9393,Beloved Beast,7301,7301,0,2019.csv,2019,100%,-
9394,Dangerous Ishq,7298,0,7298,2012.csv,2012,-,100%
9395,A Piece of Eden,7296,7296,0,2000.csv,2000,100%,-
9396,Gangster's Paradise: Jerusalema 2010 Re-release,7294,7294,0,2010.csv,2010,100%,-
9397,Another WolfCop,7285,7285,0,2017.csv,2017,100%,-
9398,Group,7281,7281,0,2002.csv,2002,100%,-
9399,Indian Point,7251,7251,0,2016.csv,2016,100%,-
9400,Outside Satan,7226,0,7226,2013.csv,2013,-,100%
9401,Tall: The American Skyscraper and Louis Sullivan,7216,7216,0,2018.csv,2018,100%,-
9402,Wake,7212,7212,0,2004.csv,2004,100%,-
9403,I Am Ali,7205,7205,0,2014.csv,2014,100%,-
9404,London River 2011 Re-release,7200,7200,0,2011.csv,2011,100%,-
9405,Happiness Runs,7199,7199,0,2010.csv,2010,100%,-
9406,Antarctic Edge: 70° South,7193,7193,0,2015.csv,2015,100%,-
9407,The Strange Color of Your Body's Tears,7182,7182,0,2014.csv,2014,100%,-
9408,ABCs of Death 2,7171,7171,0,2014.csv,2014,100%,-
9409,It Had to Be You,7162,7162,0,2016.csv,2016,100%,-
9410,"Ugly, Dirty and Bad",7144,7144,0,2016.csv,2016,100%,-
9411,Logan,7137,7137,0,2010.csv,2010,100%,-
9412,The Reagan Show,7109,5500,1609,2017.csv,2017,77.4%,22.6%
9413,Domain 2012 Re-release,7105,7105,0,2012.csv,2012,100%,-
9414,The Jazz Funeral,7103,7103,0,2017.csv,2017,100%,-
9415,The Dark Below,7095,7095,0,2017.csv,2017,100%,-
9416,Painless,7082,7082,0,2018.csv,2018,100%,-
9417,Stage Fright,7078,7078,0,2014.csv,2014,100%,-
9418,Good Neighbours,7072,7072,0,2011.csv,2011,100%,-
9419,In Echo Park,7072,7072,0,2018.csv,2018,100%,-
9420,The Brainwashing of My Dad,7028,7028,0,2016.csv,2016,100%,-
9421,In the Land of Pomegranates,7014,7014,0,2018.csv,2018,100%,-
9422,Corman's World: Exploits of a Hollywood Rebel,7000,7000,0,2011.csv,2011,100%,-
9423,Aristide and the Endless Revolution,6998,6998,0,2005.csv,2005,100%,-
9424,The Brass Teapot,6997,6997,0,2013.csv,2013,100%,-
9425,Gabriel,6959,6959,0,2015.csv,2015,100%,-
9426,"Love, Marilyn",6950,6950,0,2012.csv,2012,100%,-
9427,Los Angeles Plays Itself,6945,6945,0,2004.csv,2004,100%,-
9428,A Kind of Loving,6912,6912,0,2017.csv,2017,100%,-
9429,Assaulted: Civil Rights Under Fire,6905,6905,0,2013.csv,2013,100%,-
9430,Boom Bust Boom,6896,6896,0,2016.csv,2016,100%,-
9431,Misconceptions,6892,6892,0,2010.csv,2010,100%,-
9432,Sal,6883,6883,0,2013.csv,2013,100%,-
9433,The Human Scale,6878,6878,0,2013.csv,2013,100%,-
9434,Duck Butter,6877,6877,0,2018.csv,2018,100%,-
9435,The Sisterhood of Night,6870,6870,0,2015.csv,2015,100%,-
9436,Last Ride 2012 Re-release,6853,6853,0,2012.csv,2012,100%,-
9437,Pursuit of Happiness,6850,6850,0,2003.csv,2003,100%,-
9438,Janie Jones,6840,6840,0,2011.csv,2011,100%,-
9439,Mad Tiger,6823,6823,0,2016.csv,2016,100%,-
9440,"No God, No Master",6796,6796,0,2014.csv,2014,100%,-
9441,Finding Bliss,6783,6783,0,2010.csv,2010,100%,-
9442,Mercy,6780,6780,0,2010.csv,2010,100%,-
9443,Calling All Earthlings,6756,6756,0,2018.csv,2018,100%,-
9444,Dying to Survive 2019 Re-release,6752,6752,0,2019.csv,2019,100%,-
9445,A Whale of a Tale,6747,6747,0,2018.csv,2018,100%,-
9446,Buddha Heads,6739,6739,0,2002.csv,2002,100%,-
9447,Iceman,6719,2138,4581,2018.csv,2018,31.8%,68.2%
9448,Before You Know It,6717,6717,0,2014.csv,2014,100%,-
9449,Regina Spektor Live in London,6684,6684,0,2010.csv,2010,100%,-
9450,Arabian Nights: Volume 3 - The Enchanted One,6681,4502,2179,2015.csv,2015,67.4%,32.6%
9451,Footnotes 2017 Re-release,6660,6660,0,2017.csv,2017,100%,-
9452,Ghost Team,6639,6639,0,2016.csv,2016,100%,-
9453,The Persian Connection,6634,6634,0,2017.csv,2017,100%,-
9454,Breakfast with Curtis,6629,6629,0,2013.csv,2013,100%,-
9455,The Dying of the Light,6627,6627,0,2016.csv,2016,100%,-
9456,Brief Reunion,6601,6601,0,2013.csv,2013,100%,-
9457,Aatsinki: The Story of Arctic Cowboys,6601,6601,0,2014.csv,2014,100%,-
9458,Down the Shore,6558,6558,0,2013.csv,2013,100%,-
9459,Master of the Game,6554,6554,0,2004.csv,2004,100%,-
9460,In Our Nature,6543,6543,0,2012.csv,2012,100%,-
9461,Elizabeth Blue,6542,6542,0,2017.csv,2017,100%,-
9462,Dream Boy,6534,6534,0,2010.csv,2010,100%,-
9463,The Aggressives,6533,6533,0,2005.csv,2005,100%,-
9464,Bloody Angels,6509,6509,0,2001.csv,2001,100%,-
9465,Horse Money,6508,6508,0,2015.csv,2015,100%,-
9466,Jews of Egypt,6505,6505,0,2014.csv,2014,100%,-
9467,The Last Place on Earth,6505,6505,0,2004.csv,2004,100%,-
9468,Windfall,6504,6504,0,2012.csv,2012,100%,-
9469,Ride,6489,0,6489,2015.csv,2015,-,100%
9470,The Beat Hotel,6480,6480,0,2012.csv,2012,100%,-
9471,Santa santita,6470,6470,0,2005.csv,2005,100%,-
9472,Scum,6461,6461,0,2017.csv,2017,100%,-
9473,"White King, Red Rubber, Black Death",6458,6458,0,2005.csv,2005,100%,-
9474,McLibel,6450,4337,2113,2005.csv,2005,67.2%,32.8%
9475,Tu Dors Nicole,6445,5662,783,2015.csv,2015,87.9%,12.1%
9476,The Suicide Theory,6434,6434,0,2015.csv,2015,100%,-
9477,Some Velvet Morning,6420,6420,0,2013.csv,2013,100%,-
9478,100 Bloody Acres,6388,6388,0,2013.csv,2013,100%,-
9479,Forty Guns,6344,0,6344,2002.csv,2002,-,100%
9480,Inescapable,6334,6334,0,2013.csv,2013,100%,-
9481,The Charnel House,6332,6332,0,2016.csv,2016,100%,-
9482,Watercolors,6305,6305,0,2010.csv,2010,100%,-
9483,Dast-neveshtehaa nemisoosand,6295,6295,0,2014.csv,2014,100%,-
9484,Under the Eiffel Tower,6291,6291,0,2019.csv,2019,100%,-
9485,Solitude,6260,6260,0,2005.csv,2005,100%,-
9486,The Skyjacker's Tale,6253,6253,0,2017.csv,2017,100%,-
9487,All My Loved Ones,6237,6237,0,2002.csv,2002,100%,-
9488,One Last Thing,6232,6232,0,2018.csv,2018,100%,-
9489,In the Steps of Trisha Brown,6230,6230,0,2017.csv,2017,100%,-
9490,The Bad Kids,6226,6226,0,2016.csv,2016,100%,-
9491,A Man Vanishes 2012 Re-release,6201,6201,0,2012.csv,2012,100%,-
9492,The Red Chapel,6196,6196,0,2010.csv,2010,100%,-
9493,The Night of the Shooting Stars 2015 Re-release,6186,6186,0,2015.csv,2015,100%,-
9494,The Phantom of Liberty,6172,6172,0,2002.csv,2002,100%,-
9495,Forget Baghdad: Jews and Arabs - The Iraqi Connection,6151,3741,2410,2003.csv,2003,60.8%,39.2%
9496,Sweetwater,6147,6147,0,2013.csv,2013,100%,-
9497,Crazy Eyes,6141,6141,0,2012.csv,2012,100%,-
9498,Relaxer,6133,6133,0,2019.csv,2019,100%,-
9499,Guitar Innovators: John Fahey & Nels Cline,6132,6132,0,2013.csv,2013,100%,-
9500,Scottsboro: An American Tragedy,6123,6123,0,2001.csv,2001,100%,-
9501,"El Sicario, Room 164",6123,6123,0,2011.csv,2011,100%,-
9502,Welcome to Pine Hill,6115,6115,0,2013.csv,2013,100%,-
9503,Arise from Darkness,6112,6112,0,2017.csv,2017,100%,-
9504,Rangrezz,6108,6108,0,2013.csv,2013,100%,-
9505,The Last Fall,6100,6100,0,2012.csv,2012,100%,-
9506,The Last Time I Saw Macao,6095,6095,0,2013.csv,2013,100%,-
9507,The Calling 2003 Re-release,6092,6092,0,2003.csv,2003,100%,-
9508,The Fuzz,6067,6067,0,2017.csv,2017,100%,-
9509,The Miners' Hymns,6051,6051,0,2012.csv,2012,100%,-
9510,The Marquise of O,6048,6048,0,2015.csv,2015,100%,-
9511,Love & Air Sex,6047,6047,0,2014.csv,2014,100%,-
9512,The Family Tree,6035,6035,0,2011.csv,2011,100%,-
9513,Love Object,6028,6028,0,2004.csv,2004,100%,-
9514,BearCity,6000,6000,0,2010.csv,2010,100%,-
9515,Rat,5980,2630,3350,2001.csv,2001,44%,56%
9516,On Wings of Eagles 2017 Re-release,5975,5975,0,2017.csv,2017,100%,-
9517,"Sex, Death and Bowling",5972,5972,0,2015.csv,2015,100%,-
9518,The Playroom,5964,5964,0,2013.csv,2013,100%,-
9519,Cavemen,5948,5948,0,2014.csv,2014,100%,-
9520,Starless Dreams,5937,5937,0,2017.csv,2017,100%,-
9521,American Animal,5928,5928,0,2012.csv,2012,100%,-
9522,Sweethearts of the Prison Rodeo,5922,5922,0,2010.csv,2010,100%,-
9523,I Am MLK Jr.,5918,5918,0,2018.csv,2018,100%,-
9524,Gang of Ghosts,5906,5906,0,2014.csv,2014,100%,-
9525,Slash,5902,5902,0,2016.csv,2016,100%,-
9526,Medeas,5895,5895,0,2015.csv,2015,100%,-
9527,An Actor Prepares,5891,1743,4148,2018.csv,2018,29.6%,70.4%
9528,Infliction,5875,5875,0,2014.csv,2014,100%,-
9529,The Imperialists Are Still Alive!,5874,5874,0,2011.csv,2011,100%,-
9530,Empire of Silver 2011 Re-release,5867,0,5867,2011.csv,2011,-,100%
9531,BuzzKill,5860,5860,0,2012.csv,2012,100%,-
9532,Top Spin,5858,5858,0,2015.csv,2015,100%,-
9533,Bourek,5844,5844,0,2016.csv,2016,100%,-
9534,Shout Gladi Gladi,5839,5839,0,2015.csv,2015,100%,-
9535,Strike! 2000 Re-release,5838,5838,0,2000.csv,2000,100%,-
9536,Mauvais Sang,5812,5812,0,2001.csv,2001,100%,-
9537,Emile,5799,5799,0,2005.csv,2005,100%,-
9538,Five Dances,5788,5788,0,2013.csv,2013,100%,-
9539,Black November,5782,5782,0,2015.csv,2015,100%,-
9540,Undrafted,5777,5777,0,2016.csv,2016,100%,-
9541,Sushi: The Global Catch,5757,5757,0,2012.csv,2012,100%,-
9542,A Dark Truth,5750,5750,0,2013.csv,2013,100%,-
9543,The Overture 2005 Re-release,5740,2254,3486,2005.csv,2005,39.3%,60.7%
9544,Dream,5729,5729,0,2005.csv,2005,100%,-
9545,Klezmer on Fish Street,5724,5724,0,2004.csv,2004,100%,-
9546,Save the Date,5719,5719,0,2012.csv,2012,100%,-
9547,The Wanted 18,5680,5680,0,2015.csv,2015,100%,-
9548,People of a Feather,5677,5677,0,2013.csv,2013,100%,-
9549,The Fall of Night,5673,5673,0,2010.csv,2010,100%,-
9550,Knife Fight,5661,5661,0,2013.csv,2013,100%,-
9551,Papirosen,5658,5658,0,2014.csv,2014,100%,-
9552,This Isn't Funny,5654,5654,0,2015.csv,2015,100%,-
9553,The Roost,5642,5642,0,2005.csv,2005,100%,-
9554,Série noire,5633,5633,0,2019.csv,2019,100%,-
9555,La Chinoise 2017 Re-release,5631,5631,0,2017.csv,2017,100%,-
9556,Elevate,5580,5580,0,2011.csv,2011,100%,-
9557,Our Man in Tehran,5573,5573,0,2015.csv,2015,100%,-
9558,Kid Cannabis,5565,5565,0,2014.csv,2014,100%,-
9559,The Miracle of the Little Prince,5553,5553,0,2019.csv,2019,100%,-
9560,Booker's Place: A Mississippi Story,5549,5549,0,2012.csv,2012,100%,-
9561,American Grindhouse,5529,5529,0,2010.csv,2010,100%,-
9562,Are We Not Cats,5518,5518,0,2018.csv,2018,100%,-
9563,The Living,5514,5514,0,2015.csv,2015,100%,-
9564,Icaros: A Vision,5510,5510,0,2017.csv,2017,100%,-
9565,The First $20 Million Is Always the Hardest,5491,5491,0,2002.csv,2002,100%,-
9566,The Man from Earth: Holocene,5472,5472,0,2017.csv,2017,100%,-
9567,Quattro Noza,5471,5471,0,2005.csv,2005,100%,-
9568,Coming Soon,5453,5453,0,2000.csv,2000,100%,-
9569,Cuban Food Stories,5434,5434,0,2018.csv,2018,100%,-
9570,Flex Is Kings,5418,5418,0,2014.csv,2014,100%,-
9571,Whiz Kids,5386,5386,0,2010.csv,2010,100%,-
9572,The Only Real Game,5384,5384,0,2014.csv,2014,100%,-
9573,Particles of Truth,5348,5348,0,2004.csv,2004,100%,-
9574,"La Commune (Paris, 1871)",5340,5340,0,2003.csv,2003,100%,-
9575,She's Lost Control,5319,5319,0,2015.csv,2015,100%,-
9576,The Time Being,5274,5274,0,2013.csv,2013,100%,-
9577,It's Not Yet Dark,5269,1227,4042,2017.csv,2017,23.3%,76.7%
9578,Killers,5248,0,5248,2014.csv,2014,-,100%
9579,Sarajevo,5247,5247,0,2015.csv,2015,100%,-
9580,Speed-Dating,5240,5240,0,2010.csv,2010,100%,-
9581,Home Room,5216,5216,0,2003.csv,2003,100%,-
9582,The Princess of France,5212,5212,0,2015.csv,2015,100%,-
9583,Death Valley,5211,5211,0,2015.csv,2015,100%,-
9584,In Searching,5210,5210,0,2018.csv,2018,100%,-
9585,Chokehold,5200,5200,0,2019.csv,2019,100%,-
9586,The Gliksmans,5166,5166,0,2019.csv,2019,100%,-
9587,"Vendetta: No Conscience, No Mercy",5161,5161,0,2003.csv,2003,100%,-
9588,Lakeboat,5159,5159,0,2001.csv,2001,100%,-
9589,And They're Off,5154,5154,0,2011.csv,2011,100%,-
9590,100 Acres of Hell,5152,5152,0,2019.csv,2019,100%,-
9591,To Die Is Hard,5129,5129,0,2010.csv,2010,100%,-
9592,Body at Brighton Rock,5123,5123,0,2019.csv,2019,100%,-
9593,Return to Nuke 'Em High Volume 1,5122,5122,0,2014.csv,2014,100%,-
9594,Intersection,5116,5116,0,2018.csv,2018,100%,-
9595,Bad Lucky Goat,5088,5088,0,2017.csv,2017,100%,-
9596,On War 2015 Re-release,5086,5086,0,2015.csv,2015,100%,-
9597,Welcome to Happiness,5083,5083,0,2016.csv,2016,100%,-
9598,2307: Winter's Dream,5078,0,5078,2017.csv,2017,-,100%
9599,Bidder 70,5074,5074,0,2013.csv,2013,100%,-
9600,Tanner Hall,5073,5073,0,2011.csv,2011,100%,-
9601,Notes on an Appearance,5065,5065,0,2018.csv,2018,100%,-
9602,Chulas Fronteras,5021,5021,0,2019.csv,2019,100%,-
9603,The Sleepwalker,5012,5012,0,2014.csv,2014,100%,-
9604,The Texture of Falling,5010,5010,0,2018.csv,2018,100%,-
9605,Downtown Express,5010,5010,0,2012.csv,2012,100%,-
9606,Social Animals,5007,5007,0,2018.csv,2018,100%,-
9607,The Garden,5006,5006,0,2019.csv,2019,100%,-
9608,An L.A. Minute,5004,5004,0,2018.csv,2018,100%,-
9609,Newlyweds,5000,5000,0,2012.csv,2012,100%,-
9610,Perfect Pie,5000,5000,0,2002.csv,2002,100%,-
9611,Weekend of a Champion,4976,4100,876,2013.csv,2013,82.4%,17.6%
9612,Bringing Up Bobby,4975,4975,0,2012.csv,2012,100%,-
9613,sxtape,4961,0,4961,2014.csv,2014,-,100%
9614,Futaba kara tooku hanarete,4960,4960,0,2013.csv,2013,100%,-
9615,Herman's House,4956,4956,0,2013.csv,2013,100%,-
9616,To Die Like a Man,4955,4029,926,2011.csv,2011,81.3%,18.7%
9617,SBK: The Movie,4950,4950,0,2015.csv,2015,100%,-
9618,Tournament,4942,4942,0,2017.csv,2017,100%,-
9619,Company Town,4934,4934,0,2017.csv,2017,100%,-
9620,"Peace, Propaganda & the Promised Land",4930,4930,0,2005.csv,2005,100%,-
9621,Supporting Characters,4917,4917,0,2013.csv,2013,100%,-
9622,Guidance,4900,4900,0,2015.csv,2015,100%,-
9623,Malek,4898,4898,0,2019.csv,2019,100%,-
9624,Home of the Brave,4874,4874,0,2004.csv,2004,100%,-
9625,Revelation Road 2: The Sea of Glass and Fire,4871,4871,0,2013.csv,2013,100%,-
9626,Nothing Bad Can Happen,4870,4870,0,2014.csv,2014,100%,-
9627,Kira's Reason: A Love Story,4847,4847,0,2003.csv,2003,100%,-
9628,Call Her Applebroog,4842,4842,0,2016.csv,2016,100%,-
9629,High Times Potluck,4827,4827,0,2003.csv,2003,100%,-
9630,Ferlinghetti: A Rebirth of Wonder,4816,4816,0,2013.csv,2013,100%,-
9631,"Half The Road: The Passion, Pitfalls & Power of Women's Professional Cycling",4783,4783,0,2014.csv,2014,100%,-
9632,Perlasca,4780,4780,0,2005.csv,2005,100%,-
9633,Behind the White Glasses,4770,2223,2547,2016.csv,2016,46.6%,53.4%
9634,Secret Society,4725,4725,0,2002.csv,2002,100%,-
9635,Miss Hill: Making Dance Matter,4706,4706,0,2015.csv,2015,100%,-
9636,Shot,4701,4701,0,2017.csv,2017,100%,-
9637,Marinoni: The Fire in the Frame,4696,4696,0,2016.csv,2016,100%,-
9638,The Other Side of Everything,4685,4685,0,2018.csv,2018,100%,-
9639,Isn't This a Time! A Tribute Concert for Harold Leventhal,4683,4683,0,2005.csv,2005,100%,-
9640,Death Metal Angola,4674,4674,0,2014.csv,2014,100%,-
9641,The Long Dumb Road,4667,4667,0,2018.csv,2018,100%,-
9642,Blood on the Mountain,4664,4664,0,2016.csv,2016,100%,-
9643,Night School,4663,4663,0,2017.csv,2017,100%,-
9644,I Love You Both,4661,4661,0,2017.csv,2017,100%,-
9645,How to Draw a Bunny,4658,4658,0,2004.csv,2004,100%,-
9646,Shakespeare-Wallah,4650,4650,0,2017.csv,2017,100%,-
9647,Against the Sun,4646,4646,0,2015.csv,2015,100%,-
9648,Seeds of Time,4630,4630,0,2015.csv,2015,100%,-
9649,Miss Stevens,4611,4611,0,2016.csv,2016,100%,-
9650,Chaos,4608,4608,0,2003.csv,2003,100%,-
9651,The Automatic Hate,4603,4603,0,2016.csv,2016,100%,-
9652,Protector 2010 Re-release,4576,2968,1608,2010.csv,2010,64.9%,35.1%
9653,Search Party 2016 Re-release,4571,4571,0,2016.csv,2016,100%,-
9654,Smiling Through the Apocalypse,4560,4560,0,2014.csv,2014,100%,-
9655,All Is Bright,4556,4556,0,2013.csv,2013,100%,-
9656,A Boy Called Po,4550,4550,0,2017.csv,2017,100%,-
9657,Promised Lands,4546,4546,0,2010.csv,2010,100%,-
9658,Here Comes the Devil,4534,4534,0,2013.csv,2013,100%,-
9659,Unrelated 2014 Re-release,4529,4529,0,2014.csv,2014,100%,-
9660,Synchronicity,4505,4505,0,2016.csv,2016,100%,-
9661,The Pulitzer at 100,4489,4489,0,2017.csv,2017,100%,-
9662,I'm Leaving Now,4488,4488,0,2019.csv,2019,100%,-
9663,German Concentration Camps Factual Survey,4468,4468,0,2017.csv,2017,100%,-
9664,Weightless,4461,4461,0,2018.csv,2018,100%,-
9665,Farewell Herr Schwarz,4445,4445,0,2015.csv,2015,100%,-
9666,Generation Iron 2,4439,4439,0,2017.csv,2017,100%,-
9667,Sacred Stage: The Mariinsky Theater,4410,4410,0,2005.csv,2005,100%,-
9668,SGT. Will Gardner,4405,4405,0,2019.csv,2019,100%,-
9669,The Truth About Emanuel,4404,4404,0,2014.csv,2014,100%,-
9670,The Peacemaker,4400,4400,0,2018.csv,2018,100%,-
9671,30-LOVE,4392,4392,0,2017.csv,2017,100%,-
9672,Open My Heart,4381,4381,0,2004.csv,2004,100%,-
9673,Between Us,4380,4380,0,2013.csv,2013,100%,-
9674,The End of Time,4375,4375,0,2013.csv,2013,100%,-
9675,The Catechism Cataclysm,4373,4373,0,2011.csv,2011,100%,-
9676,The Woman Who Left,4373,3974,399,2017.csv,2017,90.9%,9.1%
9677,The Party's Just Beginning,4371,4145,226,2018.csv,2018,94.8%,5.2%
9678,The Flower of Kim Jong II,4362,4362,0,2010.csv,2010,100%,-
9679,Tito and the Birds,4332,4332,0,2019.csv,2019,100%,-
9680,On Meditation,4322,4322,0,2016.csv,2016,100%,-
9681,Days of Grace 2015 Re-release,4308,4308,0,2015.csv,2015,100%,-
9682,The Tower,4305,1117,3188,2014.csv,2014,25.9%,74.1%
9683,Auto Shop of Horrors,4300,4300,0,2016.csv,2016,100%,-
9684,My Kingdom,4296,4296,0,2002.csv,2002,100%,-
9685,The Fate of Lee Khan,4295,4295,0,2019.csv,2019,100%,-
9686,Art Is... The Permanent Revolution,4291,4291,0,2012.csv,2012,100%,-
9687,Brown's Requiem,4287,4287,0,2000.csv,2000,100%,-
9688,State Like Sleep,4282,4282,0,2019.csv,2019,100%,-
9689,Set Fire to the Stars,4280,4280,0,2015.csv,2015,100%,-
9690,Jersey Guy,4268,4268,0,2003.csv,2003,100%,-
9691,This Divided State,4255,4255,0,2005.csv,2005,100%,-
9692,The Knife of Don Juan,4254,4254,0,2015.csv,2015,100%,-
9693,My Father Die,4252,4252,0,2017.csv,2017,100%,-
9694,Stella Does Tricks,4224,4224,0,2000.csv,2000,100%,-
9695,Cocote,4224,3815,409,2018.csv,2018,90.3%,9.7%
9696,Maximum Ride,4218,4218,0,2016.csv,2016,100%,-
9697,Stella's Last Weekend,4215,4215,0,2018.csv,2018,100%,-
9698,Breaking a Monster,4212,4212,0,2016.csv,2016,100%,-
9699,Free the Nipple,4198,4198,0,2014.csv,2014,100%,-
9700,Helena from the Wedding,4190,4190,0,2010.csv,2010,100%,-
9701,Among the Believers,4189,4189,0,2016.csv,2016,100%,-
9702,3 Geezers!,4175,4175,0,2013.csv,2013,100%,-
9703,Daylight,4171,4171,0,2011.csv,2011,100%,-
9704,Melvin Goes to Dinner,4168,4168,0,2003.csv,2003,100%,-
9705,Badsville,4153,4153,0,2017.csv,2017,100%,-
9706,The Hillside Strangler,4143,4143,0,2004.csv,2004,100%,-
9707,Pawn,4141,4141,0,2013.csv,2013,100%,-
9708,Hera Purple,4123,4123,0,2002.csv,2002,100%,-
9709,Stella Street,4119,4119,0,2004.csv,2004,100%,-
9710,The Painting,4115,4115,0,2005.csv,2005,100%,-
9711,Contracted,4105,4105,0,2013.csv,2013,100%,-
9712,Ordinary Sinner,4083,4083,0,2003.csv,2003,100%,-
9713,Jason Becker: Not Dead Yet,4080,1294,2786,2012.csv,2012,31.7%,68.3%
9714,Silver Circle,4080,4080,0,2013.csv,2013,100%,-
9715,Three Night Stand,4076,4076,0,2015.csv,2015,100%,-
9716,Bandido,4064,4064,0,2004.csv,2004,100%,-
9717,The Kitchen,4054,4054,0,2013.csv,2013,100%,-
9718,Run,4052,0,4052,2020.csv,2020,-,100%
9719,La Flor,4032,4032,0,2019.csv,2019,100%,-
9720,Morning,4029,4029,0,2013.csv,2013,100%,-
9721,Approved for Adoption 2013 Re-release,4015,4015,0,2013.csv,2013,100%,-
9722,Yangsi,4008,4008,0,2012.csv,2012,100%,-
9723,Building Hope,4000,4000,0,2011.csv,2011,100%,-
9724,Pickin' & Grinnin',4000,4000,0,2012.csv,2012,100%,-
9725,Campus Radio,4000,4000,0,2011.csv,2011,100%,-
9726,Emily,3982,3982,0,2017.csv,2017,100%,-
9727,Dream Boat,3981,3981,0,2017.csv,2017,100%,-
9728,Armed,3948,3948,0,2018.csv,2018,100%,-
9729,Just Say Love,3944,3944,0,2010.csv,2010,100%,-
9730,"Blood, Friends and Money",3930,3930,0,2000.csv,2000,100%,-
9731,Mother of a Day,3919,3919,0,2019.csv,2019,100%,-
9732,Maidan,3909,3909,0,2014.csv,2014,100%,-
9733,American Dresser,3895,3895,0,2018.csv,2018,100%,-
9734,The Iron Ministry,3885,3340,545,2015.csv,2015,86%,14%
9735,Hollidaysburg,3861,3861,0,2014.csv,2014,100%,-
9736,The Second Time Around,3837,3837,0,2018.csv,2018,100%,-
9737,"High Tech, Low Life",3836,3836,0,2013.csv,2013,100%,-
9738,Aashayein,3836,0,3836,2010.csv,2010,-,100%
9739,Saints and Sinners,3826,3826,0,2004.csv,2004,100%,-
9740,Free Radicals: A History of Experimental Film,3804,3804,0,2012.csv,2012,100%,-
9741,My Wife's Name Is Maurice 2004 Re-release,3803,3803,0,2004.csv,2004,100%,-
9742,Wallflower,3801,3801,0,2019.csv,2019,100%,-
9743,A Hole in My Heart,3784,3784,0,2005.csv,2005,100%,-
9744,The Green Butchers,3783,3783,0,2004.csv,2004,100%,-
9745,Bawandar,3779,3779,0,2003.csv,2003,100%,-
9746,Unfreedom,3778,3778,0,2015.csv,2015,100%,-
9747,They Come to America,3775,3775,0,2012.csv,2012,100%,-
9748,Caravaggio,3774,3774,0,2002.csv,2002,100%,-
9749,The Gender Card Flip,3774,3774,0,2017.csv,2017,100%,-
9750,In/Significant Others,3763,3763,0,2010.csv,2010,100%,-
9751,The Hollow,3755,3755,0,2016.csv,2016,100%,-
9752,Nelly,3751,3751,0,2018.csv,2018,100%,-
9753,Bugs,3742,3742,0,2017.csv,2017,100%,-
9754,Big Animal,3733,3733,0,2004.csv,2004,100%,-
9755,Bad Blood,3731,3731,0,2012.csv,2012,100%,-
9756,The Free Speech Apocalypse,3726,3726,0,2015.csv,2015,100%,-
9757,The Condemned,3718,3718,0,2013.csv,2013,100%,-
9758,The Harvest/La Cosecha,3709,3709,0,2011.csv,2011,100%,-
9759,The Helix... Loaded,3700,3700,0,2005.csv,2005,100%,-
9760,Heartless,3697,3697,0,2010.csv,2010,100%,-
9761,The Family,3696,3696,0,2018.csv,2018,100%,-
9762,"Still, the Children Are Here",3685,3685,0,2004.csv,2004,100%,-
9763,Brothers in Arms,3664,3664,0,2004.csv,2004,100%,-
9764,Dr. Benny,3657,3657,0,2003.csv,2003,100%,-
9765,The Word,3648,3648,0,2014.csv,2014,100%,-
9766,Smash His Camera,3644,3644,0,2010.csv,2010,100%,-
9767,Stop the Pounding Heart,3642,3642,0,2014.csv,2014,100%,-
9768,The Wandering Soap Opera,3624,3624,0,2019.csv,2019,100%,-
9769,Mr. Nobody 2013 Re-release,3622,3622,0,2013.csv,2013,100%,-
9770,Warrior of Light,3617,3617,0,2003.csv,2003,100%,-
9771,Moog,3604,3604,0,2004.csv,2004,100%,-
9772,Cockfight,3600,3600,0,2004.csv,2004,100%,-
9773,Journeys with George,3588,3588,0,2003.csv,2003,100%,-
9774,Hyena,3586,3401,185,2015.csv,2015,94.8%,5.2%
9775,Hide Your Smiling Faces,3576,3576,0,2014.csv,2014,100%,-
9776,Happy Here and Now,3574,3574,0,2005.csv,2005,100%,-
9777,Evolution of a Criminal,3568,3568,0,2014.csv,2014,100%,-
9778,The Last Film Festival,3558,3558,0,2016.csv,2016,100%,-
9779,Fourplay,3550,3550,0,2018.csv,2018,100%,-
9780,Sister Helen,3541,3541,0,2003.csv,2003,100%,-
9781,La Belle Noiseuse 2017 Re-release,3540,3540,0,2017.csv,2017,100%,-
9782,Tricked,3533,3533,0,2013.csv,2013,100%,-
9783,The Loving Story 2016 Re-release,3518,3518,0,2016.csv,2016,100%,-
9784,Revolution OS,3500,3500,0,2002.csv,2002,100%,-
9785,Who's Crazy?,3497,3497,0,2017.csv,2017,100%,-
9786,Locker 13,3496,3496,0,2014.csv,2014,100%,-
9787,The Citizen 2018 Re-release,3495,3495,0,2018.csv,2018,100%,-
9788,Dead Awake,3484,0,3484,2010.csv,2010,-,100%
9789,"Love, Sweat and Tears",3482,3482,0,2017.csv,2017,100%,-
9790,Metal Messiah,3476,3476,0,2010.csv,2010,100%,-
9791,The Hacker Wars,3470,3470,0,2014.csv,2014,100%,-
9792,The Full Picture,3467,3467,0,2010.csv,2010,100%,-
9793,Short Eyes,3456,3456,0,2003.csv,2003,100%,-
9794,Aftermath,3451,3451,0,2014.csv,2014,100%,-
9795,Life's a Breeze 2014 Re-release,3450,3450,0,2014.csv,2014,100%,-
9796,Grand Theft Parsons,3438,0,3438,2004.csv,2004,-,100%
9797,Scenic Route,3434,3434,0,2013.csv,2013,100%,-
9798,Mahogany Sunrise,3432,3432,0,2014.csv,2014,100%,-
9799,Restored Me 2016 Re-release,3428,3428,0,2016.csv,2016,100%,-
9800,Speed Sisters,3423,3423,0,2017.csv,2017,100%,-
9801,The Happy Poet,3400,3400,0,2013.csv,2013,100%,-
9802,The Cage Fighter,3392,3392,0,2018.csv,2018,100%,-
9803,Tamala 2010: A Punk Cat in Space,3386,3386,0,2004.csv,2004,100%,-
9804,Rottentail,3383,3383,0,2019.csv,2019,100%,-
9805,Amanda & Jack Go Glamping,3352,3352,0,2017.csv,2017,100%,-
9806,Bad Match,3351,3351,0,2017.csv,2017,100%,-
9807,Followers,3350,3350,0,2018.csv,2018,100%,-
9808,Fashion Victim,3346,3346,0,2010.csv,2010,100%,-
9809,Swerve,3338,3338,0,2013.csv,2013,100%,-
9810,Mi America,3330,3330,0,2015.csv,2015,100%,-
9811,Know How,3323,3323,0,2015.csv,2015,100%,-
9812,Drunk Wedding,3301,3301,0,2015.csv,2015,100%,-
9813,Looking Through Lillian,3300,3300,0,2002.csv,2002,100%,-
9814,Burning Bodhi,3289,3289,0,2016.csv,2016,100%,-
9815,Axe Giant: The Wrath of Paul Bunyan,3287,3287,0,2013.csv,2013,100%,-
9816,El Superstar: The Unlikely Rise of Juan Frances,3271,3271,0,2010.csv,2010,100%,-
9817,I Love Your Work,3264,3264,0,2005.csv,2005,100%,-
9818,Justice,3259,3259,0,2017.csv,2017,100%,-
9819,Windsor Drive,3256,3256,0,2015.csv,2015,100%,-
9820,Sex Sells: The Making of 'Touché',3252,3252,0,2005.csv,2005,100%,-
9821,Over the Limit,3243,3243,0,2018.csv,2018,100%,-
9822,The Sons of Tennessee Williams,3242,3242,0,2011.csv,2011,100%,-
9823,As Cool as I Am,3234,3234,0,2013.csv,2013,100%,-
9824,The Work and the Story,3233,3233,0,2003.csv,2003,100%,-
9825,Blackhats,3216,3216,0,2015.csv,2015,100%,-
9826,A Cuban Legend,3212,3212,0,2002.csv,2002,100%,-
9827,The Backyard,3200,3200,0,2003.csv,2003,100%,-
9828,After the Wizard,3184,3184,0,2012.csv,2012,100%,-
9829,Apart,3161,3161,0,2012.csv,2012,100%,-
9830,Game Changers,3142,3142,0,2018.csv,2018,100%,-
9831,Balls to the Wall,3140,3140,0,2011.csv,2011,100%,-
9832,Hot to Trot,3133,3133,0,2018.csv,2018,100%,-
9833,The Girl on the Train,3124,3124,0,2014.csv,2014,100%,-
9834,Nowhere Man,3105,3105,0,2005.csv,2005,100%,-
9835,Showrunners: The Art of Running a TV Show,3100,3100,0,2014.csv,2014,100%,-
9836,What Now? Remind Me,3089,3089,0,2014.csv,2014,100%,-
9837,Drew: The Man Behind the Poster,3078,3078,0,2013.csv,2013,100%,-
9838,Chasing Portraits,3076,3076,0,2019.csv,2019,100%,-
9839,The Weird World of Blowfly,3062,3062,0,2011.csv,2011,100%,-
9840,The Afterlight,3059,3059,0,2010.csv,2010,100%,-
9841,Unveiled,3025,3025,0,2005.csv,2005,100%,-
9842,A French Gigolo 2014 Re-release,3021,3021,0,2014.csv,2014,100%,-
9843,A Girl and a Gun,3018,3018,0,2013.csv,2013,100%,-
9844,Best and Most Beautiful Things,3016,3016,0,2016.csv,2016,100%,-
9845,15,3013,3013,0,2005.csv,2005,100%,-
9846,Assistance mortelle,3000,3000,0,2014.csv,2014,100%,-
9847,The Ghosts of Johnson Woods,3000,3000,0,2016.csv,2016,100%,-
9848,The Lie,3000,3000,0,2011.csv,2011,100%,-
9849,Zokkomon,3000,3000,0,2011.csv,2011,100%,-
9850,Stolen Childhoods,2996,2996,0,2005.csv,2005,100%,-
9851,Moana,2993,2993,0,2015.csv,2015,100%,-
9852,Tattoo Bar,2964,2964,0,2002.csv,2002,100%,-
9853,Ash Wednesday,2942,2942,0,2002.csv,2002,100%,-
9854,Kepler's Dream,2923,2923,0,2017.csv,2017,100%,-
9855,Demons,2900,2900,0,2017.csv,2017,100%,-
9856,The Professor: Tai Chi's Journey West,2852,2852,0,2016.csv,2016,100%,-
9857,Three Days of Rain,2841,2841,0,2005.csv,2005,100%,-
9858,Okraina,2797,2797,0,2004.csv,2004,100%,-
9859,Approaching Midnight,2795,2795,0,2013.csv,2013,100%,-
9860,Nana,2784,2784,0,2018.csv,2018,100%,-
9861,Lush,2763,2763,0,2001.csv,2001,100%,-
9862,Blood Ties,2760,2760,0,2011.csv,2011,100%,-
9863,White Lies 2016 Re-release,2760,2760,0,2016.csv,2016,100%,-
9864,I Dream in Another Language,2739,2739,0,2017.csv,2017,100%,-
9865,Black Out 2014 Re-release,2734,2734,0,2014.csv,2014,100%,-
9866,The Lesser Blessed,2732,2732,0,2013.csv,2013,100%,-
9867,Julia,2710,2710,0,2015.csv,2015,100%,-
9868,Chocolat 2015 Re-release,2710,2710,0,2015.csv,2015,100%,-
9869,Adolf Eichmann,2706,2706,0,2010.csv,2010,100%,-
9870,Back to the Fatherland,2697,2697,0,2019.csv,2019,100%,-
9871,The Boys in the Band 2000 Re-release,2695,2695,0,2000.csv,2000,100%,-
9872,Santoalla,2684,2684,0,2017.csv,2017,100%,-
9873,Straight Into a Storm,2684,2684,0,2018.csv,2018,100%,-
9874,Restitution,2664,2664,0,2011.csv,2011,100%,-
9875,United Red Army 2011 Re-release,2659,2659,0,2011.csv,2011,100%,-
9876,Daughter of the Nile,2640,2640,0,2017.csv,2017,100%,-
9877,Body,2634,2634,0,2015.csv,2015,100%,-
9878,Refuge,2631,2631,0,2014.csv,2014,100%,-
9879,Indigo Children,2621,2621,0,2014.csv,2014,100%,-
9880,ACORN and the Firestorm,2621,2621,0,2018.csv,2018,100%,-
9881,The Child I Never Was,2609,2609,0,2004.csv,2004,100%,-
9882,Sparrows Dance,2602,2602,0,2013.csv,2013,100%,-
9883,Conspiracy of Silence,2598,2598,0,2004.csv,2004,100%,-
9884,Last Flight of the Champion,2597,2597,0,2013.csv,2013,100%,-
9885,Carl,2592,2592,0,2012.csv,2012,100%,-
9886,Jake Squared,2592,2592,0,2014.csv,2014,100%,-
9887,Dead or Alive: Final,2591,2591,0,2002.csv,2002,100%,-
9888,Hammer of the Gods,2590,641,1949,2013.csv,2013,24.7%,75.3%
9889,Take Me,2583,2583,0,2017.csv,2017,100%,-
9890,McCanick,2572,2572,0,2014.csv,2014,100%,-
9891,Hayride 2,2571,2571,0,2015.csv,2015,100%,-
9892,Joan the Maid 1: The Battles,2562,2562,0,2019.csv,2019,100%,-
9893,Ginger Snaps,2554,2554,0,2001.csv,2001,100%,-
9894,Cassadaga,2544,2544,0,2013.csv,2013,100%,-
9895,Whatever Happened to Harold Smith?,2543,2543,0,2001.csv,2001,100%,-
9896,Two-Bit Waltz,2540,2540,0,2014.csv,2014,100%,-
9897,Miles,2537,2537,0,2017.csv,2017,100%,-
9898,Risk/Reward,2517,2517,0,2004.csv,2004,100%,-
9899,Almost in Love,2510,2510,0,2013.csv,2013,100%,-
9900,Swing,2509,2509,0,2004.csv,2004,100%,-
9901,Mekong Hotel,2502,2502,0,2016.csv,2016,100%,-
9902,Standing by Yourself,2500,2500,0,2002.csv,2002,100%,-
9903,L'autre monde 2004 Re-release,2494,2494,0,2004.csv,2004,100%,-
9904,The Last Day of August,2492,2492,0,2013.csv,2013,100%,-
9905,Homeland (Iraq Year Zero),2491,2491,0,2016.csv,2016,100%,-
9906,Men at Lunch,2483,2483,0,2013.csv,2013,100%,-
9907,The Wait,2480,2480,0,2014.csv,2014,100%,-
9908,TINY: The Life of Erin Blackwell,2465,2465,0,2019.csv,2019,100%,-
9909,Motocross Kids,2462,2462,0,2004.csv,2004,100%,-
9910,The Ghastly Love of Johnny X,2436,2436,0,2012.csv,2012,100%,-
9911,Why Stop Now?,2432,2432,0,2012.csv,2012,100%,-
9912,The Reflektor Tapes,2424,0,2424,2015.csv,2015,-,100%
9913,Firedancer,2422,2422,0,2004.csv,2004,100%,-
9914,L.A. Slasher,2421,2421,0,2015.csv,2015,100%,-
9915,Zig Zag,2418,2418,0,2002.csv,2002,100%,-
9916,Ek Hazarachi Note,2404,2404,0,2016.csv,2016,100%,-
9917,The Optimists,2377,2377,0,2005.csv,2005,100%,-
9918,Daniel and Ana,2372,2372,0,2010.csv,2010,100%,-
9919,Evergreen: The Road to Legalization,2363,2363,0,2014.csv,2014,100%,-
9920,I Lost Albert 2019 Re-release,2354,2354,0,2019.csv,2019,100%,-
9921,A German Youth,2343,2343,0,2019.csv,2019,100%,-
9922,Lotus Eaters,2325,2325,0,2013.csv,2013,100%,-
9923,The Happy House,2311,2311,0,2013.csv,2013,100%,-
9924,Serendipity,2298,2298,0,2019.csv,2019,100%,-
9925,The Girl 2010 Re-release,2273,2201,72,2010.csv,2010,96.8%,3.2%
9926,The Pool Boys,2269,2269,0,2011.csv,2011,100%,-
9927,Red Christmas,2255,2255,0,2017.csv,2017,100%,-
9928,Anita Ho,2250,2250,0,2015.csv,2015,100%,-
9929,Memoria,2242,2242,0,2016.csv,2016,100%,-
9930,You Wont Miss Me,2240,2240,0,2010.csv,2010,100%,-
9931,The Night Watchman,2219,2219,0,2012.csv,2012,100%,-
9932,Virgil Bliss,2219,2219,0,2002.csv,2002,100%,-
9933,Side Effects,2216,2216,0,2005.csv,2005,100%,-
9934,7 from Etheria,2208,2208,0,2017.csv,2017,100%,-
9935,InSpectres,2207,2207,0,2013.csv,2013,100%,-
9936,Scorn,2206,2206,0,2012.csv,2012,100%,-
9937,Dischord,2199,2199,0,2003.csv,2003,100%,-
9938,Hell's Highway: The True Story of Highway Safety Films,2171,2171,0,2003.csv,2003,100%,-
9939,The 4th Tenor,2152,2152,0,2002.csv,2002,100%,-
9940,Stripped,2151,2151,0,2002.csv,2002,100%,-
9941,Better Living,2147,2147,0,2000.csv,2000,100%,-
9942,Stealing the Fire,2139,2139,0,2002.csv,2002,100%,-
9943,NoBody's Perfect 2010 Re-release,2122,2122,0,2010.csv,2010,100%,-
9944,Missionary,2120,2120,0,2014.csv,2014,100%,-
9945,Me You and Five Bucks,2105,2105,0,2015.csv,2015,100%,-
9946,Jihadists,2104,2104,0,2019.csv,2019,100%,-
9947,Dayveon,2077,2077,0,2017.csv,2017,100%,-
9948,Red Flag,2075,2075,0,2013.csv,2013,100%,-
9949,Rubberneck,2075,2075,0,2013.csv,2013,100%,-
9950,Patagonia Rising,2064,2064,0,2012.csv,2012,100%,-
9951,Some Body,2042,2042,0,2002.csv,2002,100%,-
9952,Choice of Weapons,2032,2032,0,2002.csv,2002,100%,-
9953,Algorithms,2021,2021,0,2014.csv,2014,100%,-
9954,Enemies of Laughter,2000,2000,0,2003.csv,2003,100%,-
9955,Split: A Deeper Divide,2000,2000,0,2012.csv,2012,100%,-
9956,The Watermelon Woman,1989,1989,0,2016.csv,2016,100%,-
9957,Falling Awake,1978,1978,0,2010.csv,2010,100%,-
9958,Steal Me,1967,1967,0,2005.csv,2005,100%,-
9959,The Temptation of St. Tony,1963,1963,0,2010.csv,2010,100%,-
9960,"Accidental Courtesy: Daryl Davis, Race & America",1940,1940,0,2017.csv,2017,100%,-
9961,Best Man Down,1938,1938,0,2013.csv,2013,100%,-
9962,West Of The Jordan River,1926,1926,0,2018.csv,2018,100%,-
9963,A Mother's Courage: Talking Back to Autism 2010 Re-release,1916,1916,0,2010.csv,2010,100%,-
9964,Mr. Smith Gets a Hustler,1915,1915,0,2002.csv,2002,100%,-
9965,Sneakerheadz,1903,1903,0,2015.csv,2015,100%,-
9966,With God on Our Side: George W. Bush and the Rise of the Religious Right in America,1884,1884,0,2005.csv,2005,100%,-
9967,We Were Here,1873,0,1873,2011.csv,2011,-,100%
9968,She's One of Us 2005 Re-release,1870,1870,0,2005.csv,2005,100%,-
9969,Finding Happiness,1841,1841,0,2018.csv,2018,100%,-
9970,Jimi Hendrix Electric Church,1818,0,1818,2019.csv,2019,-,100%
9971,Now & Later,1808,1808,0,2011.csv,2011,100%,-
9972,By Hook or by Crook,1802,1802,0,2002.csv,2002,100%,-
9973,The Opera Lover,1798,1798,0,2002.csv,2002,100%,-
9974,I Kissed a Vampire,1794,1794,0,2012.csv,2012,100%,-
9975,Detour,1788,1788,0,2017.csv,2017,100%,-
9976,The Lost Village,1780,1780,0,2018.csv,2018,100%,-
9977,Detention of the Dead,1777,1777,0,2013.csv,2013,100%,-
9978,The Other Man: F.W. de Klerk and the End of Apartheid,1747,1747,0,2015.csv,2015,100%,-
9979,Dark Forest,1739,1739,0,2015.csv,2015,100%,-
9980,You Don't Need Feet to Dance,1719,1719,0,2013.csv,2013,100%,-
9981,Das Boot ist voll 2005 Re-release,1718,1718,0,2005.csv,2005,100%,-
9982,A Beautiful Now,1714,1714,0,2016.csv,2016,100%,-
9983,The Road to Love,1714,1714,0,2004.csv,2004,100%,-
9984,The Looking Glass,1711,1711,0,2015.csv,2015,100%,-
9985,Dystopia: 2013,1708,1708,0,2012.csv,2012,100%,-
9986,Marathon,1703,1703,0,2004.csv,2004,100%,-
9987,More Than the Rainbow,1677,1677,0,2014.csv,2014,100%,-
9988,Persons of Interest,1672,1672,0,2004.csv,2004,100%,-
9989,They're Out of the Business,1655,1655,0,2011.csv,2011,100%,-
9990,Drown,1631,1631,0,2015.csv,2015,100%,-
9991,Cut Snake,1625,1625,0,2015.csv,2015,100%,-
9992,Game Day,1624,1624,0,2019.csv,2019,100%,-
9993,Rockets Redglare!,1605,1605,0,2004.csv,2004,100%,-
9994,Blindness,1602,1602,0,2003.csv,2003,100%,-
9995,Miss India America,1598,1598,0,2016.csv,2016,100%,-
9996,Forever,1598,1598,0,2015.csv,2015,100%,-
9997,Pups,1590,1590,0,2000.csv,2000,100%,-
9998,Manuela and Manuel,1582,1582,0,2010.csv,2010,100%,-
9999,Mama Africa,1581,1581,0,2002.csv,2002,100%,-
10000,Wash Dry and Spin Out,1570,1570,0,2003.csv,2003,100%,-
10001,What Boys Like,1554,1554,0,2004.csv,2004,100%,-
10002,Independent Spirits: Faith Hubley/John Hubley,1551,1551,0,2003.csv,2003,100%,-
10003,The Tunnel,1532,1532,0,2011.csv,2011,100%,-
10004,Rhymes for Young Ghouls,1529,1529,0,2014.csv,2014,100%,-
10005,"Carmo, Hit the Road 2010 Re-release",1512,1512,0,2010.csv,2010,100%,-
10006,Blackwoods,1500,1500,0,2002.csv,2002,100%,-
10007,Souldier,1500,1500,0,2014.csv,2014,100%,-
10008,Making Grace,1496,1496,0,2005.csv,2005,100%,-
10009,Where Are You Taking Me?,1492,1492,0,2012.csv,2012,100%,-
10010,Making Rounds,1484,1484,0,2015.csv,2015,100%,-
10011,Heartbreak Hospital,1480,1480,0,2002.csv,2002,100%,-
10012,The Letter: An American Town and the 'Somali Invasion',1479,1479,0,2005.csv,2005,100%,-
10013,Henchmen,1469,1469,0,2018.csv,2018,100%,-
10014,The Package,1469,1469,0,2013.csv,2013,100%,-
10015,That Way Madness Lies...,1447,1447,0,2018.csv,2018,100%,-
10016,The Ballad of Bering Strait,1440,1440,0,2003.csv,2003,100%,-
10017,Kalyug,1435,1435,0,2005.csv,2005,100%,-
10018,Monumental: David Brower's Fight for Wild America,1430,1430,0,2005.csv,2005,100%,-
10019,Bestiaire,1428,1428,0,2012.csv,2012,100%,-
10020,The Silence of Mark Rothko,1422,1422,0,2016.csv,2016,100%,-
10021,Shwaas,1416,1416,0,2004.csv,2004,100%,-
10022,The Forest for the Trees,1410,1410,0,2017.csv,2017,100%,-
10023,Drool,1403,1403,0,2010.csv,2010,100%,-
10024,"Love, Honor and Obey",1400,1400,0,2001.csv,2001,100%,-
10025,The Execution of Wanda Jean,1386,1386,0,2002.csv,2002,100%,-
10026,Besotted,1379,1379,0,2002.csv,2002,100%,-
10027,Beauty and the Beholder,1368,1368,0,2018.csv,2018,100%,-
10028,Along the Roadside 2015 Re-release,1352,1352,0,2015.csv,2015,100%,-
10029,Return to the Land of Wonders,1338,1338,0,2005.csv,2005,100%,-
10030,El Leyton,1332,1332,0,2003.csv,2003,100%,-
10031,Exorcism,1303,1303,0,2003.csv,2003,100%,-
10032,3 Nights in the Desert,1297,1297,0,2015.csv,2015,100%,-
10033,The Hours and Times,1273,1273,0,2019.csv,2019,100%,-
10034,Altered Perception,1259,1259,0,2018.csv,2018,100%,-
10035,Proteus: A Nineteenth Century Vision,1246,1246,0,2005.csv,2005,100%,-
10036,Two Men Went to War 2018 Re-release,1227,1227,0,2018.csv,2018,100%,-
10037,A Small Good Thing,1196,1196,0,2016.csv,2016,100%,-
10038,Snowman's Land,1190,1190,0,2012.csv,2012,100%,-
10039,Under the Turban,1190,1190,0,2018.csv,2018,100%,-
10040,Above and Below,1189,0,1189,2016.csv,2016,-,100%
10041,A Different American Dream,1172,1172,0,2017.csv,2017,100%,-
10042,A Zombie Invasion,1170,1170,0,2013.csv,2013,100%,-
10043,Jack & Diane,1142,1142,0,2012.csv,2012,100%,-
10044,Veer!,1132,1132,0,2013.csv,2013,100%,-
10045,Half Brothers,1100,1100,0,2018.csv,2018,100%,-
10046,We Are the Giant,1088,1088,0,2014.csv,2014,100%,-
10047,The Butterfly Room,1081,1081,0,2014.csv,2014,100%,-
10048,Childless,1036,1036,0,2015.csv,2015,100%,-
10049,Invisible Hands,1034,1034,0,2018.csv,2018,100%,-
10050,Absence,1031,1031,0,2013.csv,2013,100%,-
10051,Remnants,1022,1022,0,2013.csv,2013,100%,-
10052,The Jimmy Show,1000,1000,0,2002.csv,2002,100%,-
10053,A House on a Hill,984,984,0,2003.csv,2003,100%,-
10054,The Penguin Counters,976,976,0,2017.csv,2017,100%,-
10055,Strangers Online,968,968,0,2011.csv,2011,100%,-
10056,The Last Wave 2001 Re-release,957,957,0,2001.csv,2001,100%,-
10057,The Lonely Affair of the Heart,932,932,0,2002.csv,2002,100%,-
10058,A People Uncounted,930,930,0,2014.csv,2014,100%,-
10059,They Are We,900,900,0,2015.csv,2015,100%,-
10060,Big Muddy,881,881,0,2015.csv,2015,100%,-
10061,Extraordinary Ordinary People,880,880,0,2017.csv,2017,100%,-
10062,800 Bullets 2004 Re-release,866,866,0,2004.csv,2004,100%,-
10063,45365,853,853,0,2010.csv,2010,100%,-
10064,Officer Downe,850,850,0,2016.csv,2016,100%,-
10065,Abandoned,832,832,0,2011.csv,2011,100%,-
10066,TVTV: Video Revolutionaries,812,812,0,2018.csv,2018,100%,-
10067,Jackpot 2014 Re-release,806,806,0,2014.csv,2014,100%,-
10068,The Untold Story,790,790,0,2019.csv,2019,100%,-
10069,It's All So Quiet 2015 Re-release,724,724,0,2015.csv,2015,100%,-
10070,A Girl Like Grace,713,713,0,2016.csv,2016,100%,-
10071,Redneck Carnage,706,706,0,2011.csv,2011,100%,-
10072,The Loving Story,700,700,0,2012.csv,2012,100%,-
10073,It's Hard Being Loved by Jerks 2015 Re-release,697,697,0,2015.csv,2015,100%,-
10074,The Portal,685,0,685,2019.csv,2019,-,100%
10075,Syrup,663,663,0,2013.csv,2013,100%,-
10076,Nature Calls,646,646,0,2012.csv,2012,100%,-
10077,Spooky House 2005 Re-release,637,637,0,2005.csv,2005,100%,-
10078,Citizen Gangster,625,625,0,2012.csv,2012,100%,-
10079,Steve + Sky,624,624,0,2005.csv,2005,100%,-
10080,Anatomy 2 2004 Re-release,623,623,0,2004.csv,2004,100%,-
10081,"Jesus, You Know",604,604,0,2004.csv,2004,100%,-
10082,Gottfried Helnwein and the Dreaming Child,601,601,0,2012.csv,2012,100%,-
10083,Shake Hands with the Devil,594,594,0,2010.csv,2010,100%,-
10084,Sorority Girls' Revenge,582,582,0,2001.csv,2001,100%,-
10085,A Good Day to Die,573,573,0,2011.csv,2011,100%,-
10086,The Pit,560,560,0,2016.csv,2016,100%,-
10087,The Comedians of Comedy,549,549,0,2005.csv,2005,100%,-
10088,Higher Power,528,528,0,2018.csv,2018,100%,-
10089,Meeting Evil,525,525,0,2012.csv,2012,100%,-
10090,The 11th Hour,510,0,510,2015.csv,2015,-,100%
10091,Tasuma,479,479,0,2004.csv,2004,100%,-
10092,Triumph of the Wall,476,476,0,2013.csv,2013,100%,-
10093,Green is Gold,455,455,0,2016.csv,2016,100%,-
10094,The Dark Hours,423,423,0,2005.csv,2005,100%,-
10095,The Magician 2010 Re-release,406,406,0,2010.csv,2010,100%,-
10096,Skinless,400,400,0,2014.csv,2014,100%,-
10097,Cinemanovels,398,398,0,2014.csv,2014,100%,-
10098,A Quiet Place Part II,163,0,163,2020.csv,2020,-,100%
10099,"Mummy, I'm A Zombie",120,120,0,2014.csv,2014,100%,-
10100,Paranoid Girls,78,78,0,2015.csv,2015,100%,-
10101,Confession of a Child of the Century 2015 Re-release,74,74,0,2015.csv,2015,100%,-
